"filename", "language", "TOML", "Lua", "Markdown", "JSON", "comment", "blank", "total"
"c:\Users\colin\OneDrive\Documents\Projects\JJKBattlegrounds\.stylua.toml", "TOML", 9, 0, 0, 0, 0, 2, 11
"c:\Users\colin\OneDrive\Documents\Projects\JJKBattlegrounds\Packages\Cmdr.lua", "Lua", 0, 1, 0, 0, 0, 1, 2
"c:\Users\colin\OneDrive\Documents\Projects\JJKBattlegrounds\Packages\Janitor.lua", "Lua", 0, 2, 0, 0, 0, 0, 2
"c:\Users\colin\OneDrive\Documents\Projects\JJKBattlegrounds\Packages\LemonSignal.lua", "Lua", 0, -1, 0, 0, 0, -1, -2
"c:\Users\colin\OneDrive\Documents\Projects\JJKBattlegrounds\Packages\TopbarPlus.lua", "Lua", 0, 1, 0, 0, 0, 1, 2
"c:\Users\colin\OneDrive\Documents\Projects\JJKBattlegrounds\Packages\_Index\data-oriented-house_lemonsignal@1.10.0\lemonsignal\default.project.json", "JSON", 0, 0, 0, -6, 0, 0, -6
"c:\Users\colin\OneDrive\Documents\Projects\JJKBattlegrounds\Packages\_Index\data-oriented-house_lemonsignal@1.10.0\lemonsignal\src\LemonSignal.lua", "Lua", 0, -213, 0, 0, -7, -39, -259
"c:\Users\colin\OneDrive\Documents\Projects\JJKBattlegrounds\Packages\_Index\data-oriented-house_lemonsignal@1.10.0\lemonsignal\wally.toml", "TOML", -17, 0, 0, 0, 0, -1, -18
"c:\Users\colin\OneDrive\Documents\Projects\JJKBattlegrounds\Packages\_Index\evaera_cmdr@1.12.0\cmdr\CHANGELOG.md", "Markdown", 0, 0, 184, 0, 0, 38, 222
"c:\Users\colin\OneDrive\Documents\Projects\JJKBattlegrounds\Packages\_Index\evaera_cmdr@1.12.0\cmdr\Cmdr\BuiltInCommands\Admin\announce.lua", "Lua", 0, 13, 0, 0, 0, 0, 13
"c:\Users\colin\OneDrive\Documents\Projects\JJKBattlegrounds\Packages\_Index\evaera_cmdr@1.12.0\cmdr\Cmdr\BuiltInCommands\Admin\announceServer.lua", "Lua", 0, 12, 0, 0, 0, 3, 15
"c:\Users\colin\OneDrive\Documents\Projects\JJKBattlegrounds\Packages\_Index\evaera_cmdr@1.12.0\cmdr\Cmdr\BuiltInCommands\Admin\gotoPlace.lua", "Lua", 0, 28, 0, 0, 0, 0, 28
"c:\Users\colin\OneDrive\Documents\Projects\JJKBattlegrounds\Packages\_Index\evaera_cmdr@1.12.0\cmdr\Cmdr\BuiltInCommands\Admin\gotoPlaceServer.lua", "Lua", 0, 18, 0, 0, 0, 6, 24
"c:\Users\colin\OneDrive\Documents\Projects\JJKBattlegrounds\Packages\_Index\evaera_cmdr@1.12.0\cmdr\Cmdr\BuiltInCommands\Admin\kick.lua", "Lua", 0, 13, 0, 0, 0, 0, 13
"c:\Users\colin\OneDrive\Documents\Projects\JJKBattlegrounds\Packages\_Index\evaera_cmdr@1.12.0\cmdr\Cmdr\BuiltInCommands\Admin\kickServer.lua", "Lua", 0, 6, 0, 0, 0, 1, 7
"c:\Users\colin\OneDrive\Documents\Projects\JJKBattlegrounds\Packages\_Index\evaera_cmdr@1.12.0\cmdr\Cmdr\BuiltInCommands\Admin\kill.lua", "Lua", 0, 13, 0, 0, 0, 0, 13
"c:\Users\colin\OneDrive\Documents\Projects\JJKBattlegrounds\Packages\_Index\evaera_cmdr@1.12.0\cmdr\Cmdr\BuiltInCommands\Admin\killServer.lua", "Lua", 0, 8, 0, 0, 0, 1, 9
"c:\Users\colin\OneDrive\Documents\Projects\JJKBattlegrounds\Packages\_Index\evaera_cmdr@1.12.0\cmdr\Cmdr\BuiltInCommands\Admin\respawn.lua", "Lua", 0, 15, 0, 0, 0, 1, 16
"c:\Users\colin\OneDrive\Documents\Projects\JJKBattlegrounds\Packages\_Index\evaera_cmdr@1.12.0\cmdr\Cmdr\BuiltInCommands\Admin\respawnServer.lua", "Lua", 0, 8, 0, 0, 0, 1, 9
"c:\Users\colin\OneDrive\Documents\Projects\JJKBattlegrounds\Packages\_Index\evaera_cmdr@1.12.0\cmdr\Cmdr\BuiltInCommands\Admin\teleport.lua", "Lua", 0, 22, 0, 0, 0, 0, 22
"c:\Users\colin\OneDrive\Documents\Projects\JJKBattlegrounds\Packages\_Index\evaera_cmdr@1.12.0\cmdr\Cmdr\BuiltInCommands\Admin\teleportServer.lua", "Lua", 0, 18, 0, 0, 0, 4, 22
"c:\Users\colin\OneDrive\Documents\Projects\JJKBattlegrounds\Packages\_Index\evaera_cmdr@1.12.0\cmdr\Cmdr\BuiltInCommands\Debug\blink.lua", "Lua", 0, 16, 0, 0, 2, 5, 23
"c:\Users\colin\OneDrive\Documents\Projects\JJKBattlegrounds\Packages\_Index\evaera_cmdr@1.12.0\cmdr\Cmdr\BuiltInCommands\Debug\fetch.lua", "Lua", 0, 13, 0, 0, 0, 0, 13
"c:\Users\colin\OneDrive\Documents\Projects\JJKBattlegrounds\Packages\_Index\evaera_cmdr@1.12.0\cmdr\Cmdr\BuiltInCommands\Debug\fetchServer.lua", "Lua", 0, 4, 0, 0, 0, 1, 5
"c:\Users\colin\OneDrive\Documents\Projects\JJKBattlegrounds\Packages\_Index\evaera_cmdr@1.12.0\cmdr\Cmdr\BuiltInCommands\Debug\getPlayerPlaceInstance.lua", "Lua", 0, 21, 0, 0, 0, 0, 21
"c:\Users\colin\OneDrive\Documents\Projects\JJKBattlegrounds\Packages\_Index\evaera_cmdr@1.12.0\cmdr\Cmdr\BuiltInCommands\Debug\getPlayerPlaceInstanceServer.lua", "Lua", 0, 23, 0, 0, 0, 4, 27
"c:\Users\colin\OneDrive\Documents\Projects\JJKBattlegrounds\Packages\_Index\evaera_cmdr@1.12.0\cmdr\Cmdr\BuiltInCommands\Debug\position.lua", "Lua", 0, 22, 0, 0, 0, 4, 26
"c:\Users\colin\OneDrive\Documents\Projects\JJKBattlegrounds\Packages\_Index\evaera_cmdr@1.12.0\cmdr\Cmdr\BuiltInCommands\Debug\thru.lua", "Lua", 0, 25, 0, 0, 2, 6, 33
"c:\Users\colin\OneDrive\Documents\Projects\JJKBattlegrounds\Packages\_Index\evaera_cmdr@1.12.0\cmdr\Cmdr\BuiltInCommands\Debug\uptime.lua", "Lua", 0, 7, 0, 0, 0, 0, 7
"c:\Users\colin\OneDrive\Documents\Projects\JJKBattlegrounds\Packages\_Index\evaera_cmdr@1.12.0\cmdr\Cmdr\BuiltInCommands\Debug\uptimeServer.lua", "Lua", 0, 10, 0, 0, 0, 1, 11
"c:\Users\colin\OneDrive\Documents\Projects\JJKBattlegrounds\Packages\_Index\evaera_cmdr@1.12.0\cmdr\Cmdr\BuiltInCommands\Debug\version.lua", "Lua", 0, 10, 0, 0, 0, 3, 13
"c:\Users\colin\OneDrive\Documents\Projects\JJKBattlegrounds\Packages\_Index\evaera_cmdr@1.12.0\cmdr\Cmdr\BuiltInCommands\Utility\alias.lua", "Lua", 0, 25, 0, 0, 0, 2, 27
"c:\Users\colin\OneDrive\Documents\Projects\JJKBattlegrounds\Packages\_Index\evaera_cmdr@1.12.0\cmdr\Cmdr\BuiltInCommands\Utility\bind.lua", "Lua", 0, 56, 0, 0, 0, 9, 65
"c:\Users\colin\OneDrive\Documents\Projects\JJKBattlegrounds\Packages\_Index\evaera_cmdr@1.12.0\cmdr\Cmdr\BuiltInCommands\Utility\clear.lua", "Lua", 0, 21, 0, 0, 0, 3, 24
"c:\Users\colin\OneDrive\Documents\Projects\JJKBattlegrounds\Packages\_Index\evaera_cmdr@1.12.0\cmdr\Cmdr\BuiltInCommands\Utility\convertTimestamp.lua", "Lua", 0, 18, 0, 0, 0, 1, 19
"c:\Users\colin\OneDrive\Documents\Projects\JJKBattlegrounds\Packages\_Index\evaera_cmdr@1.12.0\cmdr\Cmdr\BuiltInCommands\Utility\echo.lua", "Lua", 0, 16, 0, 0, 0, 1, 17
"c:\Users\colin\OneDrive\Documents\Projects\JJKBattlegrounds\Packages\_Index\evaera_cmdr@1.12.0\cmdr\Cmdr\BuiltInCommands\Utility\edit.lua", "Lua", 0, 65, 0, 0, 0, 14, 79
"c:\Users\colin\OneDrive\Documents\Projects\JJKBattlegrounds\Packages\_Index\evaera_cmdr@1.12.0\cmdr\Cmdr\BuiltInCommands\Utility\history.lua", "Lua", 0, 25, 0, 0, 0, 3, 28
"c:\Users\colin\OneDrive\Documents\Projects\JJKBattlegrounds\Packages\_Index\evaera_cmdr@1.12.0\cmdr\Cmdr\BuiltInCommands\Utility\hover.lua", "Lua", 0, 16, 0, 0, 0, 5, 21
"c:\Users\colin\OneDrive\Documents\Projects\JJKBattlegrounds\Packages\_Index\evaera_cmdr@1.12.0\cmdr\Cmdr\BuiltInCommands\Utility\jsonArrayDecode.lua", "Lua", 0, 19, 0, 0, 0, 3, 22
"c:\Users\colin\OneDrive\Documents\Projects\JJKBattlegrounds\Packages\_Index\evaera_cmdr@1.12.0\cmdr\Cmdr\BuiltInCommands\Utility\jsonArrayEncode.lua", "Lua", 0, 17, 0, 0, 0, 2, 19
"c:\Users\colin\OneDrive\Documents\Projects\JJKBattlegrounds\Packages\_Index\evaera_cmdr@1.12.0\cmdr\Cmdr\BuiltInCommands\Utility\len.lua", "Lua", 0, 16, 0, 0, 0, 1, 17
"c:\Users\colin\OneDrive\Documents\Projects\JJKBattlegrounds\Packages\_Index\evaera_cmdr@1.12.0\cmdr\Cmdr\BuiltInCommands\Utility\math.lua", "Lua", 0, 34, 0, 0, 0, 2, 36
"c:\Users\colin\OneDrive\Documents\Projects\JJKBattlegrounds\Packages\_Index\evaera_cmdr@1.12.0\cmdr\Cmdr\BuiltInCommands\Utility\pick.lua", "Lua", 0, 21, 0, 0, 0, 1, 22
"c:\Users\colin\OneDrive\Documents\Projects\JJKBattlegrounds\Packages\_Index\evaera_cmdr@1.12.0\cmdr\Cmdr\BuiltInCommands\Utility\rand.lua", "Lua", 0, 22, 0, 0, 0, 1, 23
"c:\Users\colin\OneDrive\Documents\Projects\JJKBattlegrounds\Packages\_Index\evaera_cmdr@1.12.0\cmdr\Cmdr\BuiltInCommands\Utility\replace.lua", "Lua", 0, 31, 0, 0, 0, 1, 32
"c:\Users\colin\OneDrive\Documents\Projects\JJKBattlegrounds\Packages\_Index\evaera_cmdr@1.12.0\cmdr\Cmdr\BuiltInCommands\Utility\resolve.lua", "Lua", 0, 30, 0, 0, 0, 2, 32
"c:\Users\colin\OneDrive\Documents\Projects\JJKBattlegrounds\Packages\_Index\evaera_cmdr@1.12.0\cmdr\Cmdr\BuiltInCommands\Utility\run.lua", "Lua", 0, 19, 0, 0, 0, 1, 20
"c:\Users\colin\OneDrive\Documents\Projects\JJKBattlegrounds\Packages\_Index\evaera_cmdr@1.12.0\cmdr\Cmdr\BuiltInCommands\Utility\runLines.lua", "Lua", 0, 31, 0, 0, 0, 8, 39
"c:\Users\colin\OneDrive\Documents\Projects\JJKBattlegrounds\Packages\_Index\evaera_cmdr@1.12.0\cmdr\Cmdr\BuiltInCommands\Utility\runif.lua", "Lua", 0, 47, 0, 0, 0, 6, 53
"c:\Users\colin\OneDrive\Documents\Projects\JJKBattlegrounds\Packages\_Index\evaera_cmdr@1.12.0\cmdr\Cmdr\BuiltInCommands\Utility\unbind.lua", "Lua", 0, 23, 0, 0, 0, 2, 25
"c:\Users\colin\OneDrive\Documents\Projects\JJKBattlegrounds\Packages\_Index\evaera_cmdr@1.12.0\cmdr\Cmdr\BuiltInCommands\Utility\var.lua", "Lua", 0, 21, 0, 0, 0, 2, 23
"c:\Users\colin\OneDrive\Documents\Projects\JJKBattlegrounds\Packages\_Index\evaera_cmdr@1.12.0\cmdr\Cmdr\BuiltInCommands\Utility\varServer.lua", "Lua", 0, 48, 0, 0, 0, 13, 61
"c:\Users\colin\OneDrive\Documents\Projects\JJKBattlegrounds\Packages\_Index\evaera_cmdr@1.12.0\cmdr\Cmdr\BuiltInCommands\Utility\varSet.lua", "Lua", 0, 22, 0, 0, 0, 2, 24
"c:\Users\colin\OneDrive\Documents\Projects\JJKBattlegrounds\Packages\_Index\evaera_cmdr@1.12.0\cmdr\Cmdr\BuiltInCommands\Utility\varSetServer.lua", "Lua", 0, 48, 0, 0, 0, 16, 64
"c:\Users\colin\OneDrive\Documents\Projects\JJKBattlegrounds\Packages\_Index\evaera_cmdr@1.12.0\cmdr\Cmdr\BuiltInCommands\help.lua", "Lua", 0, 58, 0, 0, 2, 5, 65
"c:\Users\colin\OneDrive\Documents\Projects\JJKBattlegrounds\Packages\_Index\evaera_cmdr@1.12.0\cmdr\Cmdr\BuiltInTypes\BindableResource.lua", "Lua", 0, 3, 0, 0, 0, 1, 4
"c:\Users\colin\OneDrive\Documents\Projects\JJKBattlegrounds\Packages\_Index\evaera_cmdr@1.12.0\cmdr\Cmdr\BuiltInTypes\BrickColor.lua", "Lua", 0, 68, 0, 0, 0, 11, 79
"c:\Users\colin\OneDrive\Documents\Projects\JJKBattlegrounds\Packages\_Index\evaera_cmdr@1.12.0\cmdr\Cmdr\BuiltInTypes\Color3.lua", "Lua", 0, 43, 0, 0, 0, 10, 53
"c:\Users\colin\OneDrive\Documents\Projects\JJKBattlegrounds\Packages\_Index\evaera_cmdr@1.12.0\cmdr\Cmdr\BuiltInTypes\Command.lua", "Lua", 0, 20, 0, 0, 0, 6, 26
"c:\Users\colin\OneDrive\Documents\Projects\JJKBattlegrounds\Packages\_Index\evaera_cmdr@1.12.0\cmdr\Cmdr\BuiltInTypes\ConditionFunction.lua", "Lua", 0, 3, 0, 0, 0, 1, 4
"c:\Users\colin\OneDrive\Documents\Projects\JJKBattlegrounds\Packages\_Index\evaera_cmdr@1.12.0\cmdr\Cmdr\BuiltInTypes\Duration.lua", "Lua", 0, 90, 0, 0, 13, 10, 113
"c:\Users\colin\OneDrive\Documents\Projects\JJKBattlegrounds\Packages\_Index\evaera_cmdr@1.12.0\cmdr\Cmdr\BuiltInTypes\JSON.lua", "Lua", 0, 11, 0, 0, 0, 3, 14
"c:\Users\colin\OneDrive\Documents\Projects\JJKBattlegrounds\Packages\_Index\evaera_cmdr@1.12.0\cmdr\Cmdr\BuiltInTypes\MathOperator.lua", "Lua", 0, 40, 0, 0, 0, 1, 41
"c:\Users\colin\OneDrive\Documents\Projects\JJKBattlegrounds\Packages\_Index\evaera_cmdr@1.12.0\cmdr\Cmdr\BuiltInTypes\Player.lua", "Lua", 0, 32, 0, 0, 0, 9, 41
"c:\Users\colin\OneDrive\Documents\Projects\JJKBattlegrounds\Packages\_Index\evaera_cmdr@1.12.0\cmdr\Cmdr\BuiltInTypes\PlayerId.lua", "Lua", 0, 50, 0, 0, 0, 13, 63
"c:\Users\colin\OneDrive\Documents\Projects\JJKBattlegrounds\Packages\_Index\evaera_cmdr@1.12.0\cmdr\Cmdr\BuiltInTypes\Primitives.lua", "Lua", 0, 114, 0, 0, 0, 27, 141
"c:\Users\colin\OneDrive\Documents\Projects\JJKBattlegrounds\Packages\_Index\evaera_cmdr@1.12.0\cmdr\Cmdr\BuiltInTypes\StoredKey.lua", "Lua", 0, 28, 0, 0, 0, 7, 35
"c:\Users\colin\OneDrive\Documents\Projects\JJKBattlegrounds\Packages\_Index\evaera_cmdr@1.12.0\cmdr\Cmdr\BuiltInTypes\Team.lua", "Lua", 0, 41, 0, 0, 0, 12, 53
"c:\Users\colin\OneDrive\Documents\Projects\JJKBattlegrounds\Packages\_Index\evaera_cmdr@1.12.0\cmdr\Cmdr\BuiltInTypes\Type.lua", "Lua", 0, 20, 0, 0, 0, 6, 26
"c:\Users\colin\OneDrive\Documents\Projects\JJKBattlegrounds\Packages\_Index\evaera_cmdr@1.12.0\cmdr\Cmdr\BuiltInTypes\URL.lua", "Lua", 0, 16, 0, 0, 0, 5, 21
"c:\Users\colin\OneDrive\Documents\Projects\JJKBattlegrounds\Packages\_Index\evaera_cmdr@1.12.0\cmdr\Cmdr\BuiltInTypes\UserInput.lua", "Lua", 0, 24, 0, 0, 0, 8, 32
"c:\Users\colin\OneDrive\Documents\Projects\JJKBattlegrounds\Packages\_Index\evaera_cmdr@1.12.0\cmdr\Cmdr\BuiltInTypes\Vector.lua", "Lua", 0, 25, 0, 0, 0, 6, 31
"c:\Users\colin\OneDrive\Documents\Projects\JJKBattlegrounds\Packages\_Index\evaera_cmdr@1.12.0\cmdr\Cmdr\CmdrClient\CmdrInterface\AutoComplete.lua", "Lua", 0, 149, 0, 0, 27, 41, 217
"c:\Users\colin\OneDrive\Documents\Projects\JJKBattlegrounds\Packages\_Index\evaera_cmdr@1.12.0\cmdr\Cmdr\CmdrClient\CmdrInterface\Window.lua", "Lua", 0, 256, 0, 0, 23, 58, 337
"c:\Users\colin\OneDrive\Documents\Projects\JJKBattlegrounds\Packages\_Index\evaera_cmdr@1.12.0\cmdr\Cmdr\CmdrClient\CmdrInterface\init.lua", "Lua", 0, 117, 0, 0, 3, 32, 152
"c:\Users\colin\OneDrive\Documents\Projects\JJKBattlegrounds\Packages\_Index\evaera_cmdr@1.12.0\cmdr\Cmdr\CmdrClient\DefaultEventHandlers.lua", "Lua", 0, 13, 0, 0, 0, 2, 15
"c:\Users\colin\OneDrive\Documents\Projects\JJKBattlegrounds\Packages\_Index\evaera_cmdr@1.12.0\cmdr\Cmdr\CmdrClient\init.lua", "Lua", 0, 90, 0, 0, 14, 23, 127
"c:\Users\colin\OneDrive\Documents\Projects\JJKBattlegrounds\Packages\_Index\evaera_cmdr@1.12.0\cmdr\Cmdr\CreateGui.lua", "Lua", 0, 195, 0, 0, 0, 23, 218
"c:\Users\colin\OneDrive\Documents\Projects\JJKBattlegrounds\Packages\_Index\evaera_cmdr@1.12.0\cmdr\Cmdr\Initialize.lua", "Lua", 0, 28, 0, 0, 1, 12, 41
"c:\Users\colin\OneDrive\Documents\Projects\JJKBattlegrounds\Packages\_Index\evaera_cmdr@1.12.0\cmdr\Cmdr\Shared\Argument.lua", "Lua", 0, 196, 0, 0, 8, 54, 258
"c:\Users\colin\OneDrive\Documents\Projects\JJKBattlegrounds\Packages\_Index\evaera_cmdr@1.12.0\cmdr\Cmdr\Shared\Command.lua", "Lua", 0, 160, 0, 0, 22, 41, 223
"c:\Users\colin\OneDrive\Documents\Projects\JJKBattlegrounds\Packages\_Index\evaera_cmdr@1.12.0\cmdr\Cmdr\Shared\Dispatcher.lua", "Lua", 0, 135, 0, 0, 15, 40, 190
"c:\Users\colin\OneDrive\Documents\Projects\JJKBattlegrounds\Packages\_Index\evaera_cmdr@1.12.0\cmdr\Cmdr\Shared\Registry.lua", "Lua", 0, 213, 0, 0, 24, 58, 295
"c:\Users\colin\OneDrive\Documents\Projects\JJKBattlegrounds\Packages\_Index\evaera_cmdr@1.12.0\cmdr\Cmdr\Shared\Util.lua", "Lua", 0, 423, 0, 0, 35, 91, 549
"c:\Users\colin\OneDrive\Documents\Projects\JJKBattlegrounds\Packages\_Index\evaera_cmdr@1.12.0\cmdr\Cmdr\init.lua", "Lua", 0, 33, 0, 0, 1, 7, 41
"c:\Users\colin\OneDrive\Documents\Projects\JJKBattlegrounds\Packages\_Index\evaera_cmdr@1.12.0\cmdr\README.md", "Markdown", 0, 0, 17, 0, 0, 6, 23
"c:\Users\colin\OneDrive\Documents\Projects\JJKBattlegrounds\Packages\_Index\evaera_cmdr@1.12.0\cmdr\aftman.toml", "TOML", 4, 0, 0, 0, 3, 1, 8
"c:\Users\colin\OneDrive\Documents\Projects\JJKBattlegrounds\Packages\_Index\evaera_cmdr@1.12.0\cmdr\default.project.json", "JSON", 0, 0, 0, 6, 0, 0, 6
"c:\Users\colin\OneDrive\Documents\Projects\JJKBattlegrounds\Packages\_Index\evaera_cmdr@1.12.0\cmdr\rotriever.toml", "TOML", 6, 0, 0, 0, 0, 1, 7
"c:\Users\colin\OneDrive\Documents\Projects\JJKBattlegrounds\Packages\_Index\evaera_cmdr@1.12.0\cmdr\selene.toml", "TOML", 1, 0, 0, 0, 0, 0, 1
"c:\Users\colin\OneDrive\Documents\Projects\JJKBattlegrounds\Packages\_Index\evaera_cmdr@1.12.0\cmdr\test-place.project.json", "JSON", 0, 0, 0, 12, 0, 2, 14
"c:\Users\colin\OneDrive\Documents\Projects\JJKBattlegrounds\Packages\_Index\evaera_cmdr@1.12.0\cmdr\wally.toml", "TOML", 9, 0, 0, 0, 0, 2, 11
"c:\Users\colin\OneDrive\Documents\Projects\JJKBattlegrounds\Packages\_Index\m-ethods_topbarplus@3.0.5\topbarplus\Attribute.lua", "Lua", 0, 7, 0, 0, 5, 2, 14
"c:\Users\colin\OneDrive\Documents\Projects\JJKBattlegrounds\Packages\_Index\m-ethods_topbarplus@3.0.5\topbarplus\Elements\Caption.lua", "Lua", 0, 255, 0, 0, 14, 28, 297
"c:\Users\colin\OneDrive\Documents\Projects\JJKBattlegrounds\Packages\_Index\m-ethods_topbarplus@3.0.5\topbarplus\Elements\Container.lua", "Lua", 0, 119, 0, 0, 0, 11, 130
"c:\Users\colin\OneDrive\Documents\Projects\JJKBattlegrounds\Packages\_Index\m-ethods_topbarplus@3.0.5\topbarplus\Elements\Dropdown.lua", "Lua", 0, 148, 0, 0, 7, 11, 166
"c:\Users\colin\OneDrive\Documents\Projects\JJKBattlegrounds\Packages\_Index\m-ethods_topbarplus@3.0.5\topbarplus\Elements\Indicator.lua", "Lua", 0, 83, 0, 0, 0, 8, 91
"c:\Users\colin\OneDrive\Documents\Projects\JJKBattlegrounds\Packages\_Index\m-ethods_topbarplus@3.0.5\topbarplus\Elements\Menu.lua", "Lua", 0, 159, 0, 0, 11, 13, 183
"c:\Users\colin\OneDrive\Documents\Projects\JJKBattlegrounds\Packages\_Index\m-ethods_topbarplus@3.0.5\topbarplus\Elements\Notice.lua", "Lua", 0, 99, 0, 0, 3, 12, 114
"c:\Users\colin\OneDrive\Documents\Projects\JJKBattlegrounds\Packages\_Index\m-ethods_topbarplus@3.0.5\topbarplus\Elements\Selection.lua", "Lua", 0, 39, 0, 0, 2, 8, 49
"c:\Users\colin\OneDrive\Documents\Projects\JJKBattlegrounds\Packages\_Index\m-ethods_topbarplus@3.0.5\topbarplus\Elements\Widget.lua", "Lua", 0, 378, 0, 0, 13, 32, 423
"c:\Users\colin\OneDrive\Documents\Projects\JJKBattlegrounds\Packages\_Index\m-ethods_topbarplus@3.0.5\topbarplus\Features\Gamepad.lua", "Lua", 0, 139, 0, 0, 36, 19, 194
"c:\Users\colin\OneDrive\Documents\Projects\JJKBattlegrounds\Packages\_Index\m-ethods_topbarplus@3.0.5\topbarplus\Features\Overflow.lua", "Lua", 0, 255, 0, 0, 34, 29, 318
"c:\Users\colin\OneDrive\Documents\Projects\JJKBattlegrounds\Packages\_Index\m-ethods_topbarplus@3.0.5\topbarplus\Features\Themes\Classic.lua", "Lua", 0, 18, 0, 0, 4, 5, 27
"c:\Users\colin\OneDrive\Documents\Projects\JJKBattlegrounds\Packages\_Index\m-ethods_topbarplus@3.0.5\topbarplus\Features\Themes\Default.lua", "Lua", 0, 46, 0, 0, 20, 8, 74
"c:\Users\colin\OneDrive\Documents\Projects\JJKBattlegrounds\Packages\_Index\m-ethods_topbarplus@3.0.5\topbarplus\Features\Themes\init.lua", "Lua", 0, 275, 0, 0, 54, 23, 352
"c:\Users\colin\OneDrive\Documents\Projects\JJKBattlegrounds\Packages\_Index\m-ethods_topbarplus@3.0.5\topbarplus\GoodSignal.lua", "Lua", 0, 107, 0, 0, 58, 17, 182
"c:\Users\colin\OneDrive\Documents\Projects\JJKBattlegrounds\Packages\_Index\m-ethods_topbarplus@3.0.5\topbarplus\Janitor.lua", "Lua", 0, 293, 0, 0, 30, 54, 377
"c:\Users\colin\OneDrive\Documents\Projects\JJKBattlegrounds\Packages\_Index\m-ethods_topbarplus@3.0.5\topbarplus\README.md", "Markdown", 0, 0, 1, 0, 0, 1, 2
"c:\Users\colin\OneDrive\Documents\Projects\JJKBattlegrounds\Packages\_Index\m-ethods_topbarplus@3.0.5\topbarplus\Reference.lua", "Lua", 0, 22, 0, 0, 4, 4, 30
"c:\Users\colin\OneDrive\Documents\Projects\JJKBattlegrounds\Packages\_Index\m-ethods_topbarplus@3.0.5\topbarplus\Utility.lua", "Lua", 0, 317, 0, 0, 34, 39, 390
"c:\Users\colin\OneDrive\Documents\Projects\JJKBattlegrounds\Packages\_Index\m-ethods_topbarplus@3.0.5\topbarplus\VERSION.lua", "Lua", 0, 1, 0, 0, 0, 0, 1
"c:\Users\colin\OneDrive\Documents\Projects\JJKBattlegrounds\Packages\_Index\m-ethods_topbarplus@3.0.5\topbarplus\aftman.toml", "TOML", 2, 0, 0, 0, 3, 1, 6
"c:\Users\colin\OneDrive\Documents\Projects\JJKBattlegrounds\Packages\_Index\m-ethods_topbarplus@3.0.5\topbarplus\init.lua", "Lua", 0, 829, 0, 0, 104, 128, 1061
"c:\Users\colin\OneDrive\Documents\Projects\JJKBattlegrounds\Packages\_Index\m-ethods_topbarplus@3.0.5\topbarplus\wally.toml", "TOML", 8, 0, 0, 0, 0, 1, 9
"c:\Users\colin\OneDrive\Documents\Projects\JJKBattlegrounds\Vendor\CameraShaker\CameraShakeInstance.lua", "Lua", 0, 114, 0, 0, 5, 30, 149
"c:\Users\colin\OneDrive\Documents\Projects\JJKBattlegrounds\Vendor\CameraShaker\CameraShakePresets.lua", "Lua", 0, 65, 0, 0, 19, 15, 99
"c:\Users\colin\OneDrive\Documents\Projects\JJKBattlegrounds\Vendor\CameraShaker\init.lua", "Lua", 0, 165, 0, 0, 12, 46, 223
"c:\Users\colin\OneDrive\Documents\Projects\JJKBattlegrounds\Vendor\VFXLib.lua", "Lua", 0, 217, 0, 0, 4, 36, 257
"c:\Users\colin\OneDrive\Documents\Projects\JJKBattlegrounds\aftman.toml", "TOML", 1, 0, 0, 0, 0, 1, 2
"c:\Users\colin\OneDrive\Documents\Projects\JJKBattlegrounds\selene.toml", "TOML", 3, 0, 0, 0, 0, 2, 5
"c:\Users\colin\OneDrive\Documents\Projects\JJKBattlegrounds\src\Client\Actions\Components\Input.lua", "Lua", 0, 40, 0, 0, 0, 12, 52
"c:\Users\colin\OneDrive\Documents\Projects\JJKBattlegrounds\src\Client\Actions\Jobs\BootAbilityBar.lua", "Lua", 0, 25, 0, 0, 0, 9, 34
"c:\Users\colin\OneDrive\Documents\Projects\JJKBattlegrounds\src\Client\Actions\Jobs\BootCooldowns.lua", "Lua", 0, 19, 0, 0, 0, 9, 28
"c:\Users\colin\OneDrive\Documents\Projects\JJKBattlegrounds\src\Client\Actions\Jobs\BootInput.lua", "Lua", 0, 67, 0, 0, 8, 20, 95
"c:\Users\colin\OneDrive\Documents\Projects\JJKBattlegrounds\src\Client\Actions\Jobs\SyncActionSet.lua", "Lua", 0, 49, 0, 0, 0, 16, 65
"c:\Users\colin\OneDrive\Documents\Projects\JJKBattlegrounds\src\Client\Camera\Components\CameraAnimation.lua", "Lua", 0, 26, 0, 0, 0, 7, 33
"c:\Users\colin\OneDrive\Documents\Projects\JJKBattlegrounds\src\Client\Camera\Components\CameraShaker.lua", "Lua", 0, 13, 0, 0, 0, 9, 22
"c:\Users\colin\OneDrive\Documents\Projects\JJKBattlegrounds\src\Client\Camera\Jobs\InitCameraShaker.lua", "Lua", 0, 18, 0, 0, 0, 7, 25
"c:\Users\colin\OneDrive\Documents\Projects\JJKBattlegrounds\src\Client\Camera\Jobs\UpdateCamera\UpdateAnimation.lua", "Lua", 0, 29, 0, 0, 0, 12, 41
"c:\Users\colin\OneDrive\Documents\Projects\JJKBattlegrounds\src\Client\Camera\Jobs\UpdateCamera\init.lua", "Lua", 0, 17, 0, 0, 0, 6, 23
"c:\Users\colin\OneDrive\Documents\Projects\JJKBattlegrounds\src\Client\Cmdr\Jobs\InitializeCmdr.lua", "Lua", 0, 6, 0, 0, 0, 4, 10
"c:\Users\colin\OneDrive\Documents\Projects\JJKBattlegrounds\src\Client\Components\ActionInput.lua", "Lua", 0, -21, 0, 0, 0, -9, -30
"c:\Users\colin\OneDrive\Documents\Projects\JJKBattlegrounds\src\Client\Components\ActionSet.lua", "Lua", 0, -7, 0, 0, -1, -6, -14
"c:\Users\colin\OneDrive\Documents\Projects\JJKBattlegrounds\src\Client\Components\Character.lua", "Lua", 0, -7, 0, 0, -1, -5, -13
"c:\Users\colin\OneDrive\Documents\Projects\JJKBattlegrounds\src\Client\Components\LocalCharacter.lua", "Lua", 0, -14, 0, 0, -1, -8, -23
"c:\Users\colin\OneDrive\Documents\Projects\JJKBattlegrounds\src\Client\Components\LocalPlayer.lua", "Lua", 0, -6, 0, 0, -1, -5, -12
"c:\Users\colin\OneDrive\Documents\Projects\JJKBattlegrounds\src\Client\Components\Player.lua", "Lua", 0, -13, 0, 0, 0, -7, -20
"c:\Users\colin\OneDrive\Documents\Projects\JJKBattlegrounds\src\Client\Factories\CharacterEntity.lua", "Lua", 0, -16, 0, 0, 0, -5, -21
"c:\Users\colin\OneDrive\Documents\Projects\JJKBattlegrounds\src\Client\Factories\PlayerEntity.lua", "Lua", 0, -11, 0, 0, 0, -5, -16
"c:\Users\colin\OneDrive\Documents\Projects\JJKBattlegrounds\src\Client\Modules\Queries.lua", "Lua", 0, -8, 0, 0, 0, -4, -12
"c:\Users\colin\OneDrive\Documents\Projects\JJKBattlegrounds\src\Client\Player\Jobs\BootCharacters.lua", "Lua", 0, 16, 0, 0, 0, 6, 22
"c:\Users\colin\OneDrive\Documents\Projects\JJKBattlegrounds\src\Client\Player\Jobs\UpdateCameraOffset.lua", "Lua", 0, 18, 0, 0, 0, 6, 24
"c:\Users\colin\OneDrive\Documents\Projects\JJKBattlegrounds\src\Client\Player\Modules\CharacterChanger.lua", "Lua", 0, 10, 0, 0, 1, 6, 17
"c:\Users\colin\OneDrive\Documents\Projects\JJKBattlegrounds\src\Client\Systems\BindInputEvents.lua", "Lua", 0, -52, 0, 0, 0, -15, -67
"c:\Users\colin\OneDrive\Documents\Projects\JJKBattlegrounds\src\Client\Systems\PlayerAdded\CharacterLife.lua", "Lua", 0, -22, 0, 0, 0, -9, -31
"c:\Users\colin\OneDrive\Documents\Projects\JJKBattlegrounds\src\Client\Systems\PlayerAdded\SetupPlayer.lua", "Lua", 0, -7, 0, 0, 0, -5, -12
"c:\Users\colin\OneDrive\Documents\Projects\JJKBattlegrounds\src\Client\Systems\PlayerAdded\init.lua", "Lua", 0, -13, 0, 0, 0, -5, -18
"c:\Users\colin\OneDrive\Documents\Projects\JJKBattlegrounds\src\Client\Systems\UpdateActionSet.lua", "Lua", 0, -27, 0, 0, -1, -10, -38
"c:\Users\colin\OneDrive\Documents\Projects\JJKBattlegrounds\src\Client\Systems\UpdateLoop\PreRender\Ability1.lua", "Lua", 0, -31, 0, 0, -3, -11, -45
"c:\Users\colin\OneDrive\Documents\Projects\JJKBattlegrounds\src\Client\Systems\UpdateLoop\PreRender\Ability2.lua", "Lua", 0, -4, 0, 0, 0, -4, -8
"c:\Users\colin\OneDrive\Documents\Projects\JJKBattlegrounds\src\Client\Systems\UpdateLoop\PreRender\Ability3.lua", "Lua", 0, -4, 0, 0, 0, -4, -8
"c:\Users\colin\OneDrive\Documents\Projects\JJKBattlegrounds\src\Client\Systems\UpdateLoop\PreRender\Ability4.lua", "Lua", 0, -4, 0, 0, 0, -4, -8
"c:\Users\colin\OneDrive\Documents\Projects\JJKBattlegrounds\src\Client\Systems\UpdateLoop\PreRender\Dash.lua", "Lua", 0, -4, 0, 0, 0, -4, -8
"c:\Users\colin\OneDrive\Documents\Projects\JJKBattlegrounds\src\Client\Systems\UpdateLoop\PreRender\M1.lua", "Lua", 0, -27, 0, 0, -3, -11, -41
"c:\Users\colin\OneDrive\Documents\Projects\JJKBattlegrounds\src\Client\Systems\UpdateLoop\PreRender\UpdateProjectileTrajectory.lua", "Lua", 0, -1, 0, 0, 0, -1, -2
"c:\Users\colin\OneDrive\Documents\Projects\JJKBattlegrounds\src\Client\Systems\UpdateLoop\init.lua", "Lua", 0, -12, 0, 0, 0, -5, -17
"c:\Users\colin\OneDrive\Documents\Projects\JJKBattlegrounds\src\Client\UI\AbilityBar.lua", "Lua", 0, 66, 0, 0, 0, 17, 83
"c:\Users\colin\OneDrive\Documents\Projects\JJKBattlegrounds\src\Client\UI\AscensionBar.lua", "Lua", 0, 67, 0, 0, 0, 17, 84
"c:\Users\colin\OneDrive\Documents\Projects\JJKBattlegrounds\src\Client\UI\CharacterSelector.lua", "Lua", 0, 20, 0, 0, 1, 7, 28
"c:\Users\colin\OneDrive\Documents\Projects\JJKBattlegrounds\src\Client\World.lua", "Lua", 0, -11, 0, 0, 0, -5, -16
"c:\Users\colin\OneDrive\Documents\Projects\JJKBattlegrounds\src\Server\Actions\Jobs\ActionSetCloner.lua", "Lua", 0, 10, 0, 0, 0, 6, 16
"c:\Users\colin\OneDrive\Documents\Projects\JJKBattlegrounds\src\Server\Actions\Jobs\BootActionSet.lua", "Lua", 0, 39, 0, 0, 0, 16, 55
"c:\Users\colin\OneDrive\Documents\Projects\JJKBattlegrounds\src\Server\Actions\Jobs\BootActions.lua", "Lua", 0, 40, 0, 0, 0, 15, 55
"c:\Users\colin\OneDrive\Documents\Projects\JJKBattlegrounds\src\Server\Actions\Jobs\BootCooldowns.lua", "Lua", 0, 21, 0, 0, 0, 10, 31
"c:\Users\colin\OneDrive\Documents\Projects\JJKBattlegrounds\src\Server\Actions\Modules\HandleResponsesMelee.lua", "Lua", 0, 37, 0, 0, 0, 12, 49
"c:\Users\colin\OneDrive\Documents\Projects\JJKBattlegrounds\src\Server\Actions\Modules\HandleResponsesRanged.lua", "Lua", 0, 30, 0, 0, 0, 11, 41
"c:\Users\colin\OneDrive\Documents\Projects\JJKBattlegrounds\src\Server\Cmdr\Commands\ApplyKnockback.lua", "Lua", 0, 23, 0, 0, 0, 1, 24
"c:\Users\colin\OneDrive\Documents\Projects\JJKBattlegrounds\src\Server\Cmdr\Commands\ApplyKnockbackServer.lua", "Lua", 0, 29, 0, 0, 0, 9, 38
"c:\Users\colin\OneDrive\Documents\Projects\JJKBattlegrounds\src\Server\Cmdr\Commands\SetAscensionBar.lua", "Lua", 0, 18, 0, 0, 0, 1, 19
"c:\Users\colin\OneDrive\Documents\Projects\JJKBattlegrounds\src\Server\Cmdr\Commands\SetAscensionBarServer.lua", "Lua", 0, 18, 0, 0, 0, 8, 26
"c:\Users\colin\OneDrive\Documents\Projects\JJKBattlegrounds\src\Server\Cmdr\Commands\SetStatusEffect.lua", "Lua", 0, 23, 0, 0, 0, 1, 24
"c:\Users\colin\OneDrive\Documents\Projects\JJKBattlegrounds\src\Server\Cmdr\Commands\SetStatusEffectServer.lua", "Lua", 0, 28, 0, 0, 0, 8, 36
"c:\Users\colin\OneDrive\Documents\Projects\JJKBattlegrounds\src\Server\Cmdr\Commands\ascend.lua", "Lua", 0, 7, 0, 0, 0, 1, 8
"c:\Users\colin\OneDrive\Documents\Projects\JJKBattlegrounds\src\Server\Cmdr\Commands\ascendServer.lua", "Lua", 0, 17, 0, 0, 0, 8, 25
"c:\Users\colin\OneDrive\Documents\Projects\JJKBattlegrounds\src\Server\Cmdr\Commands\descend.lua", "Lua", 0, 7, 0, 0, 0, 1, 8
"c:\Users\colin\OneDrive\Documents\Projects\JJKBattlegrounds\src\Server\Cmdr\Commands\descendServer.lua", "Lua", 0, 16, 0, 0, 0, 8, 24
"c:\Users\colin\OneDrive\Documents\Projects\JJKBattlegrounds\src\Server\Cmdr\Commands\maxAscend.lua", "Lua", 0, 7, 0, 0, 0, 1, 8
"c:\Users\colin\OneDrive\Documents\Projects\JJKBattlegrounds\src\Server\Cmdr\Commands\maxAscendServer.lua", "Lua", 0, 16, 0, 0, 0, 8, 24
"c:\Users\colin\OneDrive\Documents\Projects\JJKBattlegrounds\src\Server\Cmdr\Hooks\BeforeRun.lua", "Lua", 0, 4, 0, 0, 7, 1, 12
"c:\Users\colin\OneDrive\Documents\Projects\JJKBattlegrounds\src\Server\Cmdr\Jobs\InitializeCmdr.lua", "Lua", 0, 9, 0, 0, 1, 6, 16
"c:\Users\colin\OneDrive\Documents\Projects\JJKBattlegrounds\src\Server\Cmdr\Types\StatusEffect.lua", "Lua", 0, 11, 0, 0, 0, 3, 14
"c:\Users\colin\OneDrive\Documents\Projects\JJKBattlegrounds\src\Server\Components\CollisionObject\Collision.lua", "Lua", 0, -7, 0, 0, -1, -5, -13
"c:\Users\colin\OneDrive\Documents\Projects\JJKBattlegrounds\src\Server\Components\UserComponents\Character.lua", "Lua", 0, -9, 0, 0, -1, -6, -16
"c:\Users\colin\OneDrive\Documents\Projects\JJKBattlegrounds\src\Server\Components\UserComponents\Cosmetics.lua", "Lua", 0, -7, 0, 0, -1, -5, -13
"c:\Users\colin\OneDrive\Documents\Projects\JJKBattlegrounds\src\Server\Components\UserComponents\Player.lua", "Lua", 0, -14, 0, 0, 0, -8, -22
"c:\Users\colin\OneDrive\Documents\Projects\JJKBattlegrounds\src\Server\Components\UserComponents\Profile.lua", "Lua", 0, -36, 0, 0, -1, -12, -49
"c:\Users\colin\OneDrive\Documents\Projects\JJKBattlegrounds\src\Server\Factories\CharacterEntity.lua", "Lua", 0, -17, 0, 0, -1, -8, -26
"c:\Users\colin\OneDrive\Documents\Projects\JJKBattlegrounds\src\Server\Factories\CollisionObject.lua", "Lua", 0, -1, 0, 0, 0, -1, -2
"c:\Users\colin\OneDrive\Documents\Projects\JJKBattlegrounds\src\Server\Factories\PlayerEntity.lua", "Lua", 0, -14, 0, 0, -4, -9, -27
"c:\Users\colin\OneDrive\Documents\Projects\JJKBattlegrounds\src\Server\Fighters\Components\LungeHitbox.lua", "Lua", 0, 18, 0, 0, 0, 7, 25
"c:\Users\colin\OneDrive\Documents\Projects\JJKBattlegrounds\src\Server\Fighters\DefaultActionSet\Attack\Client\Jobs\HandleVFX.lua", "Lua", 0, 18, 0, 0, 0, 8, 26
"c:\Users\colin\OneDrive\Documents\Projects\JJKBattlegrounds\src\Server\Fighters\DefaultActionSet\Attack\Client\init.lua", "Lua", 0, 76, 0, 0, 0, 16, 92
"c:\Users\colin\OneDrive\Documents\Projects\JJKBattlegrounds\src\Server\Fighters\DefaultActionSet\Attack\Server\Combo\Component.lua", "Lua", 0, 10, 0, 0, 0, 6, 16
"c:\Users\colin\OneDrive\Documents\Projects\JJKBattlegrounds\src\Server\Fighters\DefaultActionSet\Attack\Server\Combo\Update.lua", "Lua", 0, 14, 0, 0, 0, 5, 19
"c:\Users\colin\OneDrive\Documents\Projects\JJKBattlegrounds\src\Server\Fighters\DefaultActionSet\Attack\Server\EndCombo.lua", "Lua", 0, 97, 0, 0, 1, 26, 124
"c:\Users\colin\OneDrive\Documents\Projects\JJKBattlegrounds\src\Server\Fighters\DefaultActionSet\Attack\Server\Normal.lua", "Lua", 0, 110, 0, 0, 0, 25, 135
"c:\Users\colin\OneDrive\Documents\Projects\JJKBattlegrounds\src\Server\Fighters\DefaultActionSet\Attack\Server\Slam.lua", "Lua", 0, 97, 0, 0, 3, 28, 128
"c:\Users\colin\OneDrive\Documents\Projects\JJKBattlegrounds\src\Server\Fighters\DefaultActionSet\Attack\Server\Uppercut.lua", "Lua", 0, 97, 0, 0, 1, 27, 125
"c:\Users\colin\OneDrive\Documents\Projects\JJKBattlegrounds\src\Server\Fighters\DefaultActionSet\Attack\Server\init.lua", "Lua", 0, 124, 0, 0, 1, 28, 153
"c:\Users\colin\OneDrive\Documents\Projects\JJKBattlegrounds\src\Server\Fighters\DefaultActionSet\Block\Client\init.lua", "Lua", 0, 51, 0, 0, 0, 12, 63
"c:\Users\colin\OneDrive\Documents\Projects\JJKBattlegrounds\src\Server\Fighters\DefaultActionSet\Block\Server\init.lua", "Lua", 0, 95, 0, 0, 1, 19, 115
"c:\Users\colin\OneDrive\Documents\Projects\JJKBattlegrounds\src\Server\Fighters\DefaultActionSet\Dash\Client\VFX\Backward.lua", "Lua", 0, 35, 0, 0, 0, 12, 47
"c:\Users\colin\OneDrive\Documents\Projects\JJKBattlegrounds\src\Server\Fighters\DefaultActionSet\Dash\Client\VFX\Forward.lua", "Lua", 0, 41, 0, 0, 0, 13, 54
"c:\Users\colin\OneDrive\Documents\Projects\JJKBattlegrounds\src\Server\Fighters\DefaultActionSet\Dash\Client\VFX\MakeWindTrails.lua", "Lua", 0, 25, 0, 0, 0, 8, 33
"c:\Users\colin\OneDrive\Documents\Projects\JJKBattlegrounds\src\Server\Fighters\DefaultActionSet\Dash\Client\VFX\PaintRocks.lua", "Lua", 0, 21, 0, 0, 0, 6, 27
"c:\Users\colin\OneDrive\Documents\Projects\JJKBattlegrounds\src\Server\Fighters\DefaultActionSet\Dash\Client\VFX\Side.lua", "Lua", 0, 26, 0, 0, 0, 10, 36
"c:\Users\colin\OneDrive\Documents\Projects\JJKBattlegrounds\src\Server\Fighters\DefaultActionSet\Dash\Client\init.lua", "Lua", 0, 232, 0, 0, 1, 49, 282
"c:\Users\colin\OneDrive\Documents\Projects\JJKBattlegrounds\src\Server\Fighters\DefaultActionSet\Dash\Modules\DirectionConfig.lua", "Lua", 0, 24, 0, 0, 0, 8, 32
"c:\Users\colin\OneDrive\Documents\Projects\JJKBattlegrounds\src\Server\Fighters\DefaultActionSet\Dash\Server\init.lua", "Lua", 0, 131, 0, 0, 0, 33, 164
"c:\Users\colin\OneDrive\Documents\Projects\JJKBattlegrounds\src\Server\Fighters\DefaultActionSet\init.lua", "Lua", 0, 13, 0, 0, 0, 5, 18
"c:\Users\colin\OneDrive\Documents\Projects\JJKBattlegrounds\src\Server\Fighters\Hakari\AscendedActionSet\Cargo\Client\Jobs\HandleVFX.lua", "Lua", 0, 64, 0, 0, 5, 19, 88
"c:\Users\colin\OneDrive\Documents\Projects\JJKBattlegrounds\src\Server\Fighters\Hakari\AscendedActionSet\Cargo\Client\init.lua", "Lua", 0, 38, 0, 0, 16, 15, 69
"c:\Users\colin\OneDrive\Documents\Projects\JJKBattlegrounds\src\Server\Fighters\Hakari\AscendedActionSet\Cargo\Meta.lua", "Lua", 0, 3, 0, 0, 0, 1, 4
"c:\Users\colin\OneDrive\Documents\Projects\JJKBattlegrounds\src\Server\Fighters\Hakari\AscendedActionSet\Cargo\Server\OnHit.lua", "Lua", 0, 113, 0, 0, 43, 42, 198
"c:\Users\colin\OneDrive\Documents\Projects\JJKBattlegrounds\src\Server\Fighters\Hakari\AscendedActionSet\Cargo\Server\init.lua", "Lua", 0, 131, 0, 0, 17, 42, 190
"c:\Users\colin\OneDrive\Documents\Projects\JJKBattlegrounds\src\Server\Fighters\Hakari\AscendedActionSet\Derail\Client\Jobs\HandleVFX.lua", "Lua", 0, 64, 0, 0, 5, 19, 88
"c:\Users\colin\OneDrive\Documents\Projects\JJKBattlegrounds\src\Server\Fighters\Hakari\AscendedActionSet\Derail\Client\init.lua", "Lua", 0, 38, 0, 0, 16, 15, 69
"c:\Users\colin\OneDrive\Documents\Projects\JJKBattlegrounds\src\Server\Fighters\Hakari\AscendedActionSet\Derail\Meta.lua", "Lua", 0, 3, 0, 0, 0, 1, 4
"c:\Users\colin\OneDrive\Documents\Projects\JJKBattlegrounds\src\Server\Fighters\Hakari\AscendedActionSet\Derail\Server\OnHit.lua", "Lua", 0, 113, 0, 0, 43, 43, 199
"c:\Users\colin\OneDrive\Documents\Projects\JJKBattlegrounds\src\Server\Fighters\Hakari\AscendedActionSet\Derail\Server\init.lua", "Lua", 0, 130, 0, 0, 18, 42, 190
"c:\Users\colin\OneDrive\Documents\Projects\JJKBattlegrounds\src\Server\Fighters\Hakari\AscendedActionSet\PachinkoTransformation\Client\Jobs\HandleVFX.lua", "Lua", 0, 64, 0, 0, 5, 19, 88
"c:\Users\colin\OneDrive\Documents\Projects\JJKBattlegrounds\src\Server\Fighters\Hakari\AscendedActionSet\PachinkoTransformation\Client\init.lua", "Lua", 0, 38, 0, 0, 16, 15, 69
"c:\Users\colin\OneDrive\Documents\Projects\JJKBattlegrounds\src\Server\Fighters\Hakari\AscendedActionSet\PachinkoTransformation\Meta.lua", "Lua", 0, 3, 0, 0, 0, 1, 4
"c:\Users\colin\OneDrive\Documents\Projects\JJKBattlegrounds\src\Server\Fighters\Hakari\AscendedActionSet\PachinkoTransformation\Server\OnHit.lua", "Lua", 0, 113, 0, 0, 43, 43, 199
"c:\Users\colin\OneDrive\Documents\Projects\JJKBattlegrounds\src\Server\Fighters\Hakari\AscendedActionSet\PachinkoTransformation\Server\init.lua", "Lua", 0, 131, 0, 0, 17, 42, 190
"c:\Users\colin\OneDrive\Documents\Projects\JJKBattlegrounds\src\Server\Fighters\Hakari\AscendedActionSet\Pursuit\Client\Jobs\HandleVFX.lua", "Lua", 0, 64, 0, 0, 5, 19, 88
"c:\Users\colin\OneDrive\Documents\Projects\JJKBattlegrounds\src\Server\Fighters\Hakari\AscendedActionSet\Pursuit\Client\init.lua", "Lua", 0, 38, 0, 0, 16, 15, 69
"c:\Users\colin\OneDrive\Documents\Projects\JJKBattlegrounds\src\Server\Fighters\Hakari\AscendedActionSet\Pursuit\Meta.lua", "Lua", 0, 3, 0, 0, 0, 1, 4
"c:\Users\colin\OneDrive\Documents\Projects\JJKBattlegrounds\src\Server\Fighters\Hakari\AscendedActionSet\Pursuit\Server\OnHit.lua", "Lua", 0, 113, 0, 0, 43, 43, 199
"c:\Users\colin\OneDrive\Documents\Projects\JJKBattlegrounds\src\Server\Fighters\Hakari\AscendedActionSet\Pursuit\Server\init.lua", "Lua", 0, 131, 0, 0, 17, 42, 190
"c:\Users\colin\OneDrive\Documents\Projects\JJKBattlegrounds\src\Server\Fighters\Hakari\AscendedActionSet\init.lua", "Lua", 0, 16, 0, 0, 0, 6, 22
"c:\Users\colin\OneDrive\Documents\Projects\JJKBattlegrounds\src\Server\Fighters\Hakari\Components\Animations.lua", "Lua", 0, 20, 0, 0, 0, 10, 30
"c:\Users\colin\OneDrive\Documents\Projects\JJKBattlegrounds\src\Server\Fighters\Hakari\NormalActionSet\Ascension\Client\Jobs\HandleVFX.lua", "Lua", 0, 68, 0, 0, 10, 23, 101
"c:\Users\colin\OneDrive\Documents\Projects\JJKBattlegrounds\src\Server\Fighters\Hakari\NormalActionSet\Ascension\Client\init.lua", "Lua", 0, 36, 0, 0, 16, 15, 67
"c:\Users\colin\OneDrive\Documents\Projects\JJKBattlegrounds\src\Server\Fighters\Hakari\NormalActionSet\Ascension\Server\init.lua", "Lua", 0, 71, 0, 0, 9, 25, 105
"c:\Users\colin\OneDrive\Documents\Projects\JJKBattlegrounds\src\Server\Fighters\Hakari\NormalActionSet\DoorSlam\Client\Jobs\HandleVFX.lua", "Lua", 0, 144, 0, 0, 0, 30, 174
"c:\Users\colin\OneDrive\Documents\Projects\JJKBattlegrounds\src\Server\Fighters\Hakari\NormalActionSet\DoorSlam\Client\init.lua", "Lua", 0, 99, 0, 0, 6, 29, 134
"c:\Users\colin\OneDrive\Documents\Projects\JJKBattlegrounds\src\Server\Fighters\Hakari\NormalActionSet\DoorSlam\Meta.lua", "Lua", 0, 3, 0, 0, 0, 1, 4
"c:\Users\colin\OneDrive\Documents\Projects\JJKBattlegrounds\src\Server\Fighters\Hakari\NormalActionSet\DoorSlam\Server\init.lua", "Lua", 0, 131, 0, 0, 0, 47, 178
"c:\Users\colin\OneDrive\Documents\Projects\JJKBattlegrounds\src\Server\Fighters\Hakari\NormalActionSet\FlashyLanding\Client\Jobs\HandleVFX.lua", "Lua", 0, 34, 0, 0, 0, 12, 46
"c:\Users\colin\OneDrive\Documents\Projects\JJKBattlegrounds\src\Server\Fighters\Hakari\NormalActionSet\FlashyLanding\Client\init.lua", "Lua", 0, 62, 0, 0, 0, 15, 77
"c:\Users\colin\OneDrive\Documents\Projects\JJKBattlegrounds\src\Server\Fighters\Hakari\NormalActionSet\FlashyLanding\Meta.lua", "Lua", 0, 3, 0, 0, 0, 1, 4
"c:\Users\colin\OneDrive\Documents\Projects\JJKBattlegrounds\src\Server\Fighters\Hakari\NormalActionSet\FlashyLanding\Server\init.lua", "Lua", 0, 67, 0, 0, 1, 27, 95
"c:\Users\colin\OneDrive\Documents\Projects\JJKBattlegrounds\src\Server\Fighters\Hakari\NormalActionSet\PachinkoBarrage\Client\Jobs\HandleVFX.lua", "Lua", 0, 46, 0, 0, 0, 15, 61
"c:\Users\colin\OneDrive\Documents\Projects\JJKBattlegrounds\src\Server\Fighters\Hakari\NormalActionSet\PachinkoBarrage\Client\init.lua", "Lua", 0, 99, 0, 0, 6, 29, 134
"c:\Users\colin\OneDrive\Documents\Projects\JJKBattlegrounds\src\Server\Fighters\Hakari\NormalActionSet\PachinkoBarrage\Meta.lua", "Lua", 0, 3, 0, 0, 0, 1, 4
"c:\Users\colin\OneDrive\Documents\Projects\JJKBattlegrounds\src\Server\Fighters\Hakari\NormalActionSet\PachinkoBarrage\Server\init.lua", "Lua", 0, 112, 0, 0, 1, 39, 152
"c:\Users\colin\OneDrive\Documents\Projects\JJKBattlegrounds\src\Server\Fighters\Hakari\NormalActionSet\Slots\Client\Jobs\HandleVFX.lua", "Lua", 0, 169, 0, 0, 1, 42, 212
"c:\Users\colin\OneDrive\Documents\Projects\JJKBattlegrounds\src\Server\Fighters\Hakari\NormalActionSet\Slots\Client\init.lua", "Lua", 0, 73, 0, 0, 0, 20, 93
"c:\Users\colin\OneDrive\Documents\Projects\JJKBattlegrounds\src\Server\Fighters\Hakari\NormalActionSet\Slots\Meta.lua", "Lua", 0, 3, 0, 0, 0, 1, 4
"c:\Users\colin\OneDrive\Documents\Projects\JJKBattlegrounds\src\Server\Fighters\Hakari\NormalActionSet\Slots\Server\init.lua", "Lua", 0, 153, 0, 0, 8, 45, 206
"c:\Users\colin\OneDrive\Documents\Projects\JJKBattlegrounds\src\Server\Fighters\Hakari\NormalActionSet\init.lua", "Lua", 0, 17, 0, 0, 0, 6, 23
"c:\Users\colin\OneDrive\Documents\Projects\JJKBattlegrounds\src\Server\Fighters\Hakari\init.lua", "Lua", 0, 4, 0, 0, 0, 1, 5
"c:\Users\colin\OneDrive\Documents\Projects\JJKBattlegrounds\src\Server\Fighters\Higaruma\AscendedActionSet\Cargo\Client\Jobs\HandleVFX.lua", "Lua", 0, 64, 0, 0, 5, 19, 88
"c:\Users\colin\OneDrive\Documents\Projects\JJKBattlegrounds\src\Server\Fighters\Higaruma\AscendedActionSet\Cargo\Client\init.lua", "Lua", 0, 38, 0, 0, 16, 15, 69
"c:\Users\colin\OneDrive\Documents\Projects\JJKBattlegrounds\src\Server\Fighters\Higaruma\AscendedActionSet\Cargo\Meta.lua", "Lua", 0, 3, 0, 0, 0, 1, 4
"c:\Users\colin\OneDrive\Documents\Projects\JJKBattlegrounds\src\Server\Fighters\Higaruma\AscendedActionSet\Cargo\Server\OnHit.lua", "Lua", 0, 113, 0, 0, 43, 43, 199
"c:\Users\colin\OneDrive\Documents\Projects\JJKBattlegrounds\src\Server\Fighters\Higaruma\AscendedActionSet\Cargo\Server\init.lua", "Lua", 0, 131, 0, 0, 17, 42, 190
"c:\Users\colin\OneDrive\Documents\Projects\JJKBattlegrounds\src\Server\Fighters\Higaruma\AscendedActionSet\Derail\Client\Jobs\HandleVFX.lua", "Lua", 0, 64, 0, 0, 5, 19, 88
"c:\Users\colin\OneDrive\Documents\Projects\JJKBattlegrounds\src\Server\Fighters\Higaruma\AscendedActionSet\Derail\Client\init.lua", "Lua", 0, 38, 0, 0, 16, 15, 69
"c:\Users\colin\OneDrive\Documents\Projects\JJKBattlegrounds\src\Server\Fighters\Higaruma\AscendedActionSet\Derail\Meta.lua", "Lua", 0, 3, 0, 0, 0, 1, 4
"c:\Users\colin\OneDrive\Documents\Projects\JJKBattlegrounds\src\Server\Fighters\Higaruma\AscendedActionSet\Derail\Server\OnHit.lua", "Lua", 0, 113, 0, 0, 43, 43, 199
"c:\Users\colin\OneDrive\Documents\Projects\JJKBattlegrounds\src\Server\Fighters\Higaruma\AscendedActionSet\Derail\Server\init.lua", "Lua", 0, 130, 0, 0, 18, 42, 190
"c:\Users\colin\OneDrive\Documents\Projects\JJKBattlegrounds\src\Server\Fighters\Higaruma\AscendedActionSet\PachinkoTransformation\Client\Jobs\HandleVFX.lua", "Lua", 0, 64, 0, 0, 5, 19, 88
"c:\Users\colin\OneDrive\Documents\Projects\JJKBattlegrounds\src\Server\Fighters\Higaruma\AscendedActionSet\PachinkoTransformation\Client\init.lua", "Lua", 0, 38, 0, 0, 16, 15, 69
"c:\Users\colin\OneDrive\Documents\Projects\JJKBattlegrounds\src\Server\Fighters\Higaruma\AscendedActionSet\PachinkoTransformation\Meta.lua", "Lua", 0, 3, 0, 0, 0, 1, 4
"c:\Users\colin\OneDrive\Documents\Projects\JJKBattlegrounds\src\Server\Fighters\Higaruma\AscendedActionSet\PachinkoTransformation\Server\OnHit.lua", "Lua", 0, 113, 0, 0, 43, 43, 199
"c:\Users\colin\OneDrive\Documents\Projects\JJKBattlegrounds\src\Server\Fighters\Higaruma\AscendedActionSet\PachinkoTransformation\Server\init.lua", "Lua", 0, 131, 0, 0, 17, 42, 190
"c:\Users\colin\OneDrive\Documents\Projects\JJKBattlegrounds\src\Server\Fighters\Higaruma\AscendedActionSet\Pursuit\Client\Jobs\HandleVFX.lua", "Lua", 0, 64, 0, 0, 5, 19, 88
"c:\Users\colin\OneDrive\Documents\Projects\JJKBattlegrounds\src\Server\Fighters\Higaruma\AscendedActionSet\Pursuit\Client\init.lua", "Lua", 0, 38, 0, 0, 16, 15, 69
"c:\Users\colin\OneDrive\Documents\Projects\JJKBattlegrounds\src\Server\Fighters\Higaruma\AscendedActionSet\Pursuit\Meta.lua", "Lua", 0, 3, 0, 0, 0, 1, 4
"c:\Users\colin\OneDrive\Documents\Projects\JJKBattlegrounds\src\Server\Fighters\Higaruma\AscendedActionSet\Pursuit\Server\OnHit.lua", "Lua", 0, 113, 0, 0, 43, 43, 199
"c:\Users\colin\OneDrive\Documents\Projects\JJKBattlegrounds\src\Server\Fighters\Higaruma\AscendedActionSet\Pursuit\Server\init.lua", "Lua", 0, 131, 0, 0, 17, 42, 190
"c:\Users\colin\OneDrive\Documents\Projects\JJKBattlegrounds\src\Server\Fighters\Higaruma\AscendedActionSet\init.lua", "Lua", 0, 16, 0, 0, 0, 6, 22
"c:\Users\colin\OneDrive\Documents\Projects\JJKBattlegrounds\src\Server\Fighters\Higaruma\Components\Animations.lua", "Lua", 0, 20, 0, 0, 0, 10, 30
"c:\Users\colin\OneDrive\Documents\Projects\JJKBattlegrounds\src\Server\Fighters\Higaruma\NormalActionSet\Ascension\Client\Jobs\HandleVFX.lua", "Lua", 0, 68, 0, 0, 10, 23, 101
"c:\Users\colin\OneDrive\Documents\Projects\JJKBattlegrounds\src\Server\Fighters\Higaruma\NormalActionSet\Ascension\Client\init.lua", "Lua", 0, 36, 0, 0, 16, 15, 67
"c:\Users\colin\OneDrive\Documents\Projects\JJKBattlegrounds\src\Server\Fighters\Higaruma\NormalActionSet\Ascension\Server\init.lua", "Lua", 0, 71, 0, 0, 9, 25, 105
"c:\Users\colin\OneDrive\Documents\Projects\JJKBattlegrounds\src\Server\Fighters\Higaruma\NormalActionSet\DoorSlam\Client\Jobs\HandleVFX.lua", "Lua", 0, 38, 0, 0, 0, 13, 51
"c:\Users\colin\OneDrive\Documents\Projects\JJKBattlegrounds\src\Server\Fighters\Higaruma\NormalActionSet\DoorSlam\Client\init.lua", "Lua", 0, 62, 0, 0, 0, 15, 77
"c:\Users\colin\OneDrive\Documents\Projects\JJKBattlegrounds\src\Server\Fighters\Higaruma\NormalActionSet\DoorSlam\Meta.lua", "Lua", 0, 3, 0, 0, 0, 1, 4
"c:\Users\colin\OneDrive\Documents\Projects\JJKBattlegrounds\src\Server\Fighters\Higaruma\NormalActionSet\DoorSlam\Server\init.lua", "Lua", 0, 76, 0, 0, 0, 27, 103
"c:\Users\colin\OneDrive\Documents\Projects\JJKBattlegrounds\src\Server\Fighters\Higaruma\NormalActionSet\FlashyLanding\Client\Jobs\HandleVFX.lua", "Lua", 0, 34, 0, 0, 0, 12, 46
"c:\Users\colin\OneDrive\Documents\Projects\JJKBattlegrounds\src\Server\Fighters\Higaruma\NormalActionSet\FlashyLanding\Client\init.lua", "Lua", 0, 62, 0, 0, 0, 15, 77
"c:\Users\colin\OneDrive\Documents\Projects\JJKBattlegrounds\src\Server\Fighters\Higaruma\NormalActionSet\FlashyLanding\Meta.lua", "Lua", 0, 3, 0, 0, 0, 1, 4
"c:\Users\colin\OneDrive\Documents\Projects\JJKBattlegrounds\src\Server\Fighters\Higaruma\NormalActionSet\FlashyLanding\Server\init.lua", "Lua", 0, 67, 0, 0, 1, 27, 95
"c:\Users\colin\OneDrive\Documents\Projects\JJKBattlegrounds\src\Server\Fighters\Higaruma\NormalActionSet\PachinkoBarrage\Client\Jobs\HandleVFX.lua", "Lua", 0, 46, 0, 0, 0, 15, 61
"c:\Users\colin\OneDrive\Documents\Projects\JJKBattlegrounds\src\Server\Fighters\Higaruma\NormalActionSet\PachinkoBarrage\Client\init.lua", "Lua", 0, 62, 0, 0, 0, 15, 77
"c:\Users\colin\OneDrive\Documents\Projects\JJKBattlegrounds\src\Server\Fighters\Higaruma\NormalActionSet\PachinkoBarrage\Meta.lua", "Lua", 0, 3, 0, 0, 0, 1, 4
"c:\Users\colin\OneDrive\Documents\Projects\JJKBattlegrounds\src\Server\Fighters\Higaruma\NormalActionSet\PachinkoBarrage\Server\init.lua", "Lua", 0, 88, 0, 0, 1, 30, 119
"c:\Users\colin\OneDrive\Documents\Projects\JJKBattlegrounds\src\Server\Fighters\Higaruma\NormalActionSet\Slots\Client\Jobs\HandleVFX.lua", "Lua", 0, 38, 0, 0, 0, 13, 51
"c:\Users\colin\OneDrive\Documents\Projects\JJKBattlegrounds\src\Server\Fighters\Higaruma\NormalActionSet\Slots\Client\init.lua", "Lua", 0, 62, 0, 0, 0, 15, 77
"c:\Users\colin\OneDrive\Documents\Projects\JJKBattlegrounds\src\Server\Fighters\Higaruma\NormalActionSet\Slots\Meta.lua", "Lua", 0, 3, 0, 0, 0, 1, 4
"c:\Users\colin\OneDrive\Documents\Projects\JJKBattlegrounds\src\Server\Fighters\Higaruma\NormalActionSet\Slots\Server\init.lua", "Lua", 0, 74, 0, 0, 1, 27, 102
"c:\Users\colin\OneDrive\Documents\Projects\JJKBattlegrounds\src\Server\Fighters\Higaruma\NormalActionSet\init.lua", "Lua", 0, 17, 0, 0, 0, 6, 23
"c:\Users\colin\OneDrive\Documents\Projects\JJKBattlegrounds\src\Server\Fighters\Higaruma\init.lua", "Lua", 0, 4, 0, 0, 0, 1, 5
"c:\Users\colin\OneDrive\Documents\Projects\JJKBattlegrounds\src\Server\Fighters\Jobs\UpdateLungeHitbox.lua", "Lua", 0, 28, 0, 0, 0, 10, 38
"c:\Users\colin\OneDrive\Documents\Projects\JJKBattlegrounds\src\Server\Fighters\Kashimo\AscendedActionSet\Activation\Client\Jobs\HandleVFX.lua", "Lua", 0, 43, 0, 0, 0, 15, 58
"c:\Users\colin\OneDrive\Documents\Projects\JJKBattlegrounds\src\Server\Fighters\Kashimo\AscendedActionSet\Activation\Client\init.lua", "Lua", 0, 32, 0, 0, 4, 11, 47
"c:\Users\colin\OneDrive\Documents\Projects\JJKBattlegrounds\src\Server\Fighters\Kashimo\AscendedActionSet\Activation\Server\init.lua", "Lua", 0, 121, 0, 0, 4, 35, 160
"c:\Users\colin\OneDrive\Documents\Projects\JJKBattlegrounds\src\Server\Fighters\Kashimo\AscendedActionSet\Catatumbo\Client\Jobs\HandleVFX.lua", "Lua", 0, 98, 0, 0, 0, 25, 123
"c:\Users\colin\OneDrive\Documents\Projects\JJKBattlegrounds\src\Server\Fighters\Kashimo\AscendedActionSet\Catatumbo\Client\init.lua", "Lua", 0, 56, 0, 0, 0, 15, 71
"c:\Users\colin\OneDrive\Documents\Projects\JJKBattlegrounds\src\Server\Fighters\Kashimo\AscendedActionSet\Catatumbo\Meta.lua", "Lua", 0, 3, 0, 0, 0, 1, 4
"c:\Users\colin\OneDrive\Documents\Projects\JJKBattlegrounds\src\Server\Fighters\Kashimo\AscendedActionSet\Catatumbo\Server\init.lua", "Lua", 0, 141, 0, 0, 3, 41, 185
"c:\Users\colin\OneDrive\Documents\Projects\JJKBattlegrounds\src\Server\Fighters\Kashimo\AscendedActionSet\LightningAura\Client\Jobs\HandleVFX.lua", "Lua", 0, 73, 0, 0, 3, 27, 103
"c:\Users\colin\OneDrive\Documents\Projects\JJKBattlegrounds\src\Server\Fighters\Kashimo\AscendedActionSet\LightningAura\Client\init.lua", "Lua", 0, 56, 0, 0, 0, 15, 71
"c:\Users\colin\OneDrive\Documents\Projects\JJKBattlegrounds\src\Server\Fighters\Kashimo\AscendedActionSet\LightningAura\Meta.lua", "Lua", 0, 3, 0, 0, 0, 1, 4
"c:\Users\colin\OneDrive\Documents\Projects\JJKBattlegrounds\src\Server\Fighters\Kashimo\AscendedActionSet\LightningAura\Server\init.lua", "Lua", 0, 183, 0, 0, 15, 45, 243
"c:\Users\colin\OneDrive\Documents\Projects\JJKBattlegrounds\src\Server\Fighters\Kashimo\AscendedActionSet\LightningUppercut\Client\Jobs\HandleVFX.lua", "Lua", 0, 93, 0, 0, 0, 29, 122
"c:\Users\colin\OneDrive\Documents\Projects\JJKBattlegrounds\src\Server\Fighters\Kashimo\AscendedActionSet\LightningUppercut\Client\init.lua", "Lua", 0, 54, 0, 0, 0, 14, 68
"c:\Users\colin\OneDrive\Documents\Projects\JJKBattlegrounds\src\Server\Fighters\Kashimo\AscendedActionSet\LightningUppercut\Meta.lua", "Lua", 0, 3, 0, 0, 0, 1, 4
"c:\Users\colin\OneDrive\Documents\Projects\JJKBattlegrounds\src\Server\Fighters\Kashimo\AscendedActionSet\LightningUppercut\Server\OnHit.lua", "Lua", 0, 124, 0, 0, 12, 41, 177
"c:\Users\colin\OneDrive\Documents\Projects\JJKBattlegrounds\src\Server\Fighters\Kashimo\AscendedActionSet\LightningUppercut\Server\init.lua", "Lua", 0, 147, 0, 0, 7, 37, 191
"c:\Users\colin\OneDrive\Documents\Projects\JJKBattlegrounds\src\Server\Fighters\Kashimo\AscendedActionSet\OverwhelmingLightningBarrage\Client\Jobs\HandleVFX.lua", "Lua", 0, 64, 0, 0, 5, 19, 88
"c:\Users\colin\OneDrive\Documents\Projects\JJKBattlegrounds\src\Server\Fighters\Kashimo\AscendedActionSet\OverwhelmingLightningBarrage\Client\init.lua", "Lua", 0, 40, 0, 0, 14, 15, 69
"c:\Users\colin\OneDrive\Documents\Projects\JJKBattlegrounds\src\Server\Fighters\Kashimo\AscendedActionSet\OverwhelmingLightningBarrage\Meta.lua", "Lua", 0, 3, 0, 0, 0, 1, 4
"c:\Users\colin\OneDrive\Documents\Projects\JJKBattlegrounds\src\Server\Fighters\Kashimo\AscendedActionSet\OverwhelmingLightningBarrage\Server\OnHit.lua", "Lua", 0, 116, 0, 0, 40, 43, 199
"c:\Users\colin\OneDrive\Documents\Projects\JJKBattlegrounds\src\Server\Fighters\Kashimo\AscendedActionSet\OverwhelmingLightningBarrage\Server\init.lua", "Lua", 0, 135, 0, 0, 13, 42, 190
"c:\Users\colin\OneDrive\Documents\Projects\JJKBattlegrounds\src\Server\Fighters\Kashimo\AscendedActionSet\init.lua", "Lua", 0, 17, 0, 0, 0, 6, 23
"c:\Users\colin\OneDrive\Documents\Projects\JJKBattlegrounds\src\Server\Fighters\Kashimo\Components\Animations.lua", "Lua", 0, 20, 0, 0, 0, 10, 30
"c:\Users\colin\OneDrive\Documents\Projects\JJKBattlegrounds\src\Server\Fighters\Kashimo\NormalActionSet\Activation\Client\init.lua", "Lua", 0, 31, 0, 0, 8, 10, 49
"c:\Users\colin\OneDrive\Documents\Projects\JJKBattlegrounds\src\Server\Fighters\Kashimo\NormalActionSet\Activation\Server\init.lua", "Lua", 0, 60, 0, 0, 1, 23, 84
"c:\Users\colin\OneDrive\Documents\Projects\JJKBattlegrounds\src\Server\Fighters\Kashimo\NormalActionSet\Ascension\Client\Jobs\HandleVFX.lua", "Lua", 0, 139, 0, 0, 23, 34, 196
"c:\Users\colin\OneDrive\Documents\Projects\JJKBattlegrounds\src\Server\Fighters\Kashimo\NormalActionSet\Ascension\Client\init.lua", "Lua", 0, 68, 0, 0, 0, 19, 87
"c:\Users\colin\OneDrive\Documents\Projects\JJKBattlegrounds\src\Server\Fighters\Kashimo\NormalActionSet\Ascension\Server\init.lua", "Lua", 0, 136, 0, 0, 1, 34, 171
"c:\Users\colin\OneDrive\Documents\Projects\JJKBattlegrounds\src\Server\Fighters\Kashimo\NormalActionSet\Attack\Client\Jobs\HandleVFX.lua", "Lua", 0, 50, 0, 0, 5, 20, 75
"c:\Users\colin\OneDrive\Documents\Projects\JJKBattlegrounds\src\Server\Fighters\Kashimo\NormalActionSet\Attack\Client\init.lua", "Lua", 0, 76, 0, 0, 0, 16, 92
"c:\Users\colin\OneDrive\Documents\Projects\JJKBattlegrounds\src\Server\Fighters\Kashimo\NormalActionSet\Attack\Server\Combo\Component.lua", "Lua", 0, 10, 0, 0, 0, 6, 16
"c:\Users\colin\OneDrive\Documents\Projects\JJKBattlegrounds\src\Server\Fighters\Kashimo\NormalActionSet\Attack\Server\Combo\Update.lua", "Lua", 0, 14, 0, 0, 0, 5, 19
"c:\Users\colin\OneDrive\Documents\Projects\JJKBattlegrounds\src\Server\Fighters\Kashimo\NormalActionSet\Attack\Server\EndCombo.lua", "Lua", 0, 99, 0, 0, 1, 27, 127
"c:\Users\colin\OneDrive\Documents\Projects\JJKBattlegrounds\src\Server\Fighters\Kashimo\NormalActionSet\Attack\Server\Normal.lua", "Lua", 0, 110, 0, 0, 0, 25, 135
"c:\Users\colin\OneDrive\Documents\Projects\JJKBattlegrounds\src\Server\Fighters\Kashimo\NormalActionSet\Attack\Server\Slam.lua", "Lua", 0, 92, 0, 0, 3, 28, 123
"c:\Users\colin\OneDrive\Documents\Projects\JJKBattlegrounds\src\Server\Fighters\Kashimo\NormalActionSet\Attack\Server\Uppercut.lua", "Lua", 0, 92, 0, 0, 1, 27, 120
"c:\Users\colin\OneDrive\Documents\Projects\JJKBattlegrounds\src\Server\Fighters\Kashimo\NormalActionSet\Attack\Server\init.lua", "Lua", 0, 123, 0, 0, 1, 28, 152
"c:\Users\colin\OneDrive\Documents\Projects\JJKBattlegrounds\src\Server\Fighters\Kashimo\NormalActionSet\Dash\Client\VFX\Backward.lua", "Lua", 0, 36, 0, 0, 0, 13, 49
"c:\Users\colin\OneDrive\Documents\Projects\JJKBattlegrounds\src\Server\Fighters\Kashimo\NormalActionSet\Dash\Client\VFX\Forward.lua", "Lua", 0, 41, 0, 0, 0, 13, 54
"c:\Users\colin\OneDrive\Documents\Projects\JJKBattlegrounds\src\Server\Fighters\Kashimo\NormalActionSet\Dash\Client\VFX\MakeWindTrails.lua", "Lua", 0, 25, 0, 0, 0, 8, 33
"c:\Users\colin\OneDrive\Documents\Projects\JJKBattlegrounds\src\Server\Fighters\Kashimo\NormalActionSet\Dash\Client\VFX\PaintRocks.lua", "Lua", 0, 21, 0, 0, 0, 6, 27
"c:\Users\colin\OneDrive\Documents\Projects\JJKBattlegrounds\src\Server\Fighters\Kashimo\NormalActionSet\Dash\Client\VFX\Side.lua", "Lua", 0, 26, 0, 0, 0, 10, 36
"c:\Users\colin\OneDrive\Documents\Projects\JJKBattlegrounds\src\Server\Fighters\Kashimo\NormalActionSet\Dash\Client\init.lua", "Lua", 0, 232, 0, 0, 1, 49, 282
"c:\Users\colin\OneDrive\Documents\Projects\JJKBattlegrounds\src\Server\Fighters\Kashimo\NormalActionSet\Dash\Modules\DirectionConfig.lua", "Lua", 0, 24, 0, 0, 0, 8, 32
"c:\Users\colin\OneDrive\Documents\Projects\JJKBattlegrounds\src\Server\Fighters\Kashimo\NormalActionSet\Dash\Server\init.lua", "Lua", 0, 135, 0, 0, 0, 34, 169
"c:\Users\colin\OneDrive\Documents\Projects\JJKBattlegrounds\src\Server\Fighters\Kashimo\NormalActionSet\LightningDash\Client\Jobs\HandleVFX.lua", "Lua", 0, 61, 0, 0, 6, 17, 84
"c:\Users\colin\OneDrive\Documents\Projects\JJKBattlegrounds\src\Server\Fighters\Kashimo\NormalActionSet\LightningDash\Client\init.lua", "Lua", 0, 60, 0, 0, 0, 12, 72
"c:\Users\colin\OneDrive\Documents\Projects\JJKBattlegrounds\src\Server\Fighters\Kashimo\NormalActionSet\LightningDash\Meta.lua", "Lua", 0, 3, 0, 0, 0, 1, 4
"c:\Users\colin\OneDrive\Documents\Projects\JJKBattlegrounds\src\Server\Fighters\Kashimo\NormalActionSet\LightningDash\Server\Teleport.lua", "Lua", 0, 80, 0, 0, 0, 24, 104
"c:\Users\colin\OneDrive\Documents\Projects\JJKBattlegrounds\src\Server\Fighters\Kashimo\NormalActionSet\LightningDash\Server\init.lua", "Lua", 0, 78, 0, 0, 0, 22, 100
"c:\Users\colin\OneDrive\Documents\Projects\JJKBattlegrounds\src\Server\Fighters\Kashimo\NormalActionSet\LightningGrab\Client\init.lua", "Lua", 0, 61, 0, 0, 0, 14, 75
"c:\Users\colin\OneDrive\Documents\Projects\JJKBattlegrounds\src\Server\Fighters\Kashimo\NormalActionSet\LightningGrab\Meta.lua", "Lua", 0, 3, 0, 0, 0, 1, 4
"c:\Users\colin\OneDrive\Documents\Projects\JJKBattlegrounds\src\Server\Fighters\Kashimo\NormalActionSet\LightningGrab\Server\init.lua", "Lua", 0, 91, 0, 0, 8, 21, 120
"c:\Users\colin\OneDrive\Documents\Projects\JJKBattlegrounds\src\Server\Fighters\Kashimo\NormalActionSet\LightningJavelin\Client\Jobs\HandleVFX.lua", "Lua", 0, 124, 0, 0, 0, 29, 153
"c:\Users\colin\OneDrive\Documents\Projects\JJKBattlegrounds\src\Server\Fighters\Kashimo\NormalActionSet\LightningJavelin\Client\init.lua", "Lua", 0, 61, 0, 0, 0, 14, 75
"c:\Users\colin\OneDrive\Documents\Projects\JJKBattlegrounds\src\Server\Fighters\Kashimo\NormalActionSet\LightningJavelin\Meta.lua", "Lua", 0, 3, 0, 0, 0, 1, 4
"c:\Users\colin\OneDrive\Documents\Projects\JJKBattlegrounds\src\Server\Fighters\Kashimo\NormalActionSet\LightningJavelin\Server\OnImpact.lua", "Lua", 0, 107, 0, 0, 5, 32, 144
"c:\Users\colin\OneDrive\Documents\Projects\JJKBattlegrounds\src\Server\Fighters\Kashimo\NormalActionSet\LightningJavelin\Server\Throw.lua", "Lua", 0, 116, 0, 0, 2, 31, 149
"c:\Users\colin\OneDrive\Documents\Projects\JJKBattlegrounds\src\Server\Fighters\Kashimo\NormalActionSet\LightningJavelin\Server\init.lua", "Lua", 0, 76, 0, 0, 0, 26, 102
"c:\Users\colin\OneDrive\Documents\Projects\JJKBattlegrounds\src\Server\Fighters\Kashimo\NormalActionSet\ThunderStrike\Client\Jobs\HandleVFX.lua", "Lua", 0, 104, 0, 0, 5, 27, 136
"c:\Users\colin\OneDrive\Documents\Projects\JJKBattlegrounds\src\Server\Fighters\Kashimo\NormalActionSet\ThunderStrike\Client\init.lua", "Lua", 0, 57, 0, 0, 0, 14, 71
"c:\Users\colin\OneDrive\Documents\Projects\JJKBattlegrounds\src\Server\Fighters\Kashimo\NormalActionSet\ThunderStrike\Meta.lua", "Lua", 0, 3, 0, 0, 0, 1, 4
"c:\Users\colin\OneDrive\Documents\Projects\JJKBattlegrounds\src\Server\Fighters\Kashimo\NormalActionSet\ThunderStrike\Server\init.lua", "Lua", 0, 126, 0, 0, 3, 33, 162
"c:\Users\colin\OneDrive\Documents\Projects\JJKBattlegrounds\src\Server\Fighters\Kashimo\NormalActionSet\init.lua", "Lua", 0, 20, 0, 0, 0, 6, 26
"c:\Users\colin\OneDrive\Documents\Projects\JJKBattlegrounds\src\Server\Fighters\Kashimo\init.lua", "Lua", 0, 4, 0, 0, 0, 1, 5
"c:\Users\colin\OneDrive\Documents\Projects\JJKBattlegrounds\src\Server\Hitboxes\Enums\DamageDefense.lua", "Lua", 0, 7, 0, 0, 0, 3, 10
"c:\Users\colin\OneDrive\Documents\Projects\JJKBattlegrounds\src\Server\Hitboxes\Enums\EffectDefense.lua", "Lua", 0, 7, 0, 0, 0, 3, 10
"c:\Users\colin\OneDrive\Documents\Projects\JJKBattlegrounds\src\Server\Hitboxes\Enums\KnockbackDefense.lua", "Lua", 0, 7, 0, 0, 0, 3, 10
"c:\Users\colin\OneDrive\Documents\Projects\JJKBattlegrounds\src\Server\Hitboxes\Functions\CheckCounter.lua", "Lua", 0, 13, 0, 0, 0, 3, 16
"c:\Users\colin\OneDrive\Documents\Projects\JJKBattlegrounds\src\Server\Hitboxes\Functions\GetDefense.lua", "Lua", 0, 21, 0, 0, 0, 6, 27
"c:\Users\colin\OneDrive\Documents\Projects\JJKBattlegrounds\src\Server\Hitboxes\Functions\GetEntitiesWithCharacterFromParts.lua", "Lua", 0, 15, 0, 0, 0, 5, 20
"c:\Users\colin\OneDrive\Documents\Projects\JJKBattlegrounds\src\Server\Hitboxes\Functions\GetResponse.lua", "Lua", 0, 11, 0, 0, 0, 2, 13
"c:\Users\colin\OneDrive\Documents\Projects\JJKBattlegrounds\src\Server\Hitboxes\Types.lua", "Lua", 0, 23, 0, 0, 0, 5, 28
"c:\Users\colin\OneDrive\Documents\Projects\JJKBattlegrounds\src\Server\Modules\EntityServices\CharacterSelector.lua", "Lua", 0, -1, 0, 0, 0, -1, -2
"c:\Users\colin\OneDrive\Documents\Projects\JJKBattlegrounds\src\Server\Modules\ListenForAnimations.lua", "Lua", 0, -2, 0, 0, -14, -4, -20
"c:\Users\colin\OneDrive\Documents\Projects\JJKBattlegrounds\src\Server\Modules\Profiles.lua", "Lua", 0, -23, 0, 0, 0, -8, -31
"c:\Users\colin\OneDrive\Documents\Projects\JJKBattlegrounds\src\Server\Modules\Queries.lua", "Lua", 0, -3, 0, 0, 0, -3, -6
"c:\Users\colin\OneDrive\Documents\Projects\JJKBattlegrounds\src\Server\Player\Components\AscensionMeter.lua", "Lua", 0, 15, 0, 0, 1, 5, 21
"c:\Users\colin\OneDrive\Documents\Projects\JJKBattlegrounds\src\Server\Player\Components\Cosmetics.lua", "Lua", 0, 7, 0, 0, 1, 5, 13
"c:\Users\colin\OneDrive\Documents\Projects\JJKBattlegrounds\src\Server\Player\Components\Profile.lua", "Lua", 0, 37, 0, 0, 1, 13, 51
"c:\Users\colin\OneDrive\Documents\Projects\JJKBattlegrounds\src\Server\Player\Jobs\AscensionTracker.lua", "Lua", 0, 13, 0, 0, 0, 5, 18
"c:\Users\colin\OneDrive\Documents\Projects\JJKBattlegrounds\src\Server\Player\Jobs\AscensionUpdater.lua", "Lua", 0, 22, 0, 0, 0, 10, 32
"c:\Users\colin\OneDrive\Documents\Projects\JJKBattlegrounds\src\Server\Player\Jobs\BootCharacters.lua", "Lua", 0, 25, 0, 0, 0, 8, 33
"c:\Users\colin\OneDrive\Documents\Projects\JJKBattlegrounds\src\Server\Player\Jobs\BootPlayers.lua", "Lua", 0, 13, 0, 0, 0, 7, 20
"c:\Users\colin\OneDrive\Documents\Projects\JJKBattlegrounds\src\Server\Player\Jobs\BootSetFighter.lua", "Lua", 0, 33, 0, 0, 1, 15, 49
"c:\Users\colin\OneDrive\Documents\Projects\JJKBattlegrounds\src\Server\Player\Jobs\Ragdoll.lua", "Lua", 0, 50, 0, 0, 0, 11, 61
"c:\Users\colin\OneDrive\Documents\Projects\JJKBattlegrounds\src\Server\Player\Modules\ActionSetChanger.lua", "Lua", 0, 15, 0, 0, 0, 11, 26
"c:\Users\colin\OneDrive\Documents\Projects\JJKBattlegrounds\src\Server\Player\Modules\AscensionAdder.lua", "Lua", 0, 41, 0, 0, 1, 17, 59
"c:\Users\colin\OneDrive\Documents\Projects\JJKBattlegrounds\src\Server\Player\Modules\CharacterSelector.lua", "Lua", 0, 1, 0, 0, 0, 1, 2
"c:\Users\colin\OneDrive\Documents\Projects\JJKBattlegrounds\src\Server\Player\Modules\Profiles.lua", "Lua", 0, 28, 0, 0, 0, 8, 36
"c:\Users\colin\OneDrive\Documents\Projects\JJKBattlegrounds\src\Server\Projectiles\Components\Projectile.lua", "Lua", 0, 32, 0, 0, 0, 10, 42
"c:\Users\colin\OneDrive\Documents\Projects\JJKBattlegrounds\src\Server\Projectiles\Jobs\UpdateProjectileTrajectory.lua", "Lua", 0, 46, 0, 0, 1, 11, 58
"c:\Users\colin\OneDrive\Documents\Projects\JJKBattlegrounds\src\Server\StatusEffects\Applier.lua", "Lua", 0, 31, 0, 0, 0, 9, 40
"c:\Users\colin\OneDrive\Documents\Projects\JJKBattlegrounds\src\Server\StatusEffects\Defense\Components\Damage.lua", "Lua", 0, 11, 0, 0, 0, 6, 17
"c:\Users\colin\OneDrive\Documents\Projects\JJKBattlegrounds\src\Server\StatusEffects\Defense\Components\Effect.lua", "Lua", 0, 11, 0, 0, 0, 6, 17
"c:\Users\colin\OneDrive\Documents\Projects\JJKBattlegrounds\src\Server\StatusEffects\Defense\Components\Knockback.lua", "Lua", 0, 11, 0, 0, 0, 6, 17
"c:\Users\colin\OneDrive\Documents\Projects\JJKBattlegrounds\src\Server\StatusEffects\Defense\Jobs\Decay.lua", "Lua", 0, 22, 0, 0, 0, 6, 28
"c:\Users\colin\OneDrive\Documents\Projects\JJKBattlegrounds\src\Server\StatusEffects\Knockback\Component.lua", "Lua", 0, 27, 0, 0, 28, 14, 69
"c:\Users\colin\OneDrive\Documents\Projects\JJKBattlegrounds\src\Server\StatusEffects\Knockback\Jobs\PreSimulation.lua", "Lua", 0, 14, 0, 0, 4, 6, 24
"c:\Users\colin\OneDrive\Documents\Projects\JJKBattlegrounds\src\Server\StatusEffects\NoJump\Component.lua", "Lua", 0, 10, 0, 0, 1, 6, 17
"c:\Users\colin\OneDrive\Documents\Projects\JJKBattlegrounds\src\Server\StatusEffects\NoJump\Jobs\Lifecycle.lua", "Lua", 0, 32, 0, 0, 0, 9, 41
"c:\Users\colin\OneDrive\Documents\Projects\JJKBattlegrounds\src\Server\StatusEffects\NoJump\Jobs\PreSimulation.lua", "Lua", 0, 13, 0, 0, 0, 5, 18
"c:\Users\colin\OneDrive\Documents\Projects\JJKBattlegrounds\src\Server\StatusEffects\Ragdoll\Component.lua", "Lua", 0, 84, 0, 0, 2, 23, 109
"c:\Users\colin\OneDrive\Documents\Projects\JJKBattlegrounds\src\Server\StatusEffects\Ragdoll\Jobs\Lifecycle.lua", "Lua", 0, 27, 0, 0, 0, 7, 34
"c:\Users\colin\OneDrive\Documents\Projects\JJKBattlegrounds\src\Server\StatusEffects\Ragdoll\Jobs\PreSimulation.lua", "Lua", 0, 13, 0, 0, 0, 5, 18
"c:\Users\colin\OneDrive\Documents\Projects\JJKBattlegrounds\src\Server\StatusEffects\Silenced\Component.lua", "Lua", 0, 10, 0, 0, 1, 6, 17
"c:\Users\colin\OneDrive\Documents\Projects\JJKBattlegrounds\src\Server\StatusEffects\Silenced\Jobs\Lifecycle.lua", "Lua", 0, 22, 0, 0, 0, 7, 29
"c:\Users\colin\OneDrive\Documents\Projects\JJKBattlegrounds\src\Server\StatusEffects\Silenced\Jobs\PreSimulation.lua", "Lua", 0, 13, 0, 0, 0, 5, 18
"c:\Users\colin\OneDrive\Documents\Projects\JJKBattlegrounds\src\Server\StatusEffects\Slowed\Component.lua", "Lua", 0, 11, 0, 0, 1, 6, 18
"c:\Users\colin\OneDrive\Documents\Projects\JJKBattlegrounds\src\Server\StatusEffects\Slowed\Jobs\Lifecycle.lua", "Lua", 0, 26, 0, 0, 2, 10, 38
"c:\Users\colin\OneDrive\Documents\Projects\JJKBattlegrounds\src\Server\StatusEffects\Slowed\Jobs\PreSimulation.lua", "Lua", 0, 13, 0, 0, 0, 5, 18
"c:\Users\colin\OneDrive\Documents\Projects\JJKBattlegrounds\src\Server\Systems\HandleActionRequests.lua", "Lua", 0, -15, 0, 0, 0, -6, -21
"c:\Users\colin\OneDrive\Documents\Projects\JJKBattlegrounds\src\Server\Systems\HandleCharacterChangeRequests.lua", "Lua", 0, -1, 0, 0, 0, -1, -2
"c:\Users\colin\OneDrive\Documents\Projects\JJKBattlegrounds\src\Server\Systems\PlayerAdded\CharacterLife.lua", "Lua", 0, -22, 0, 0, 0, -8, -30
"c:\Users\colin\OneDrive\Documents\Projects\JJKBattlegrounds\src\Server\Systems\PlayerAdded\SetupPlayer.lua", "Lua", 0, -7, 0, 0, 0, -5, -12
"c:\Users\colin\OneDrive\Documents\Projects\JJKBattlegrounds\src\Server\Systems\PlayerAdded\init.lua", "Lua", 0, -13, 0, 0, 0, -5, -18
"c:\Users\colin\OneDrive\Documents\Projects\JJKBattlegrounds\src\Server\Systems\UpdateLoop\PreSimulation\UpdateHitbox.lua", "Lua", 0, -1, 0, 0, 0, -1, -2
"c:\Users\colin\OneDrive\Documents\Projects\JJKBattlegrounds\src\Server\Systems\UpdateLoop\PreSimulation\UpdateProjectileTrajectory.lua", "Lua", 0, 0, 0, 0, 0, -1, -1
"c:\Users\colin\OneDrive\Documents\Projects\JJKBattlegrounds\src\Server\Systems\UpdateLoop\init.lua", "Lua", 0, -12, 0, 0, 0, -5, -17
"c:\Users\colin\OneDrive\Documents\Projects\JJKBattlegrounds\src\Server\World.lua", "Lua", 0, -22, 0, 0, 0, -9, -31
"c:\Users\colin\OneDrive\Documents\Projects\JJKBattlegrounds\src\Shared\Config\ActionEnum.lua", "Lua", 0, -13, 0, 0, 0, -3, -16
"c:\Users\colin\OneDrive\Documents\Projects\JJKBattlegrounds\src\Shared\Config\GlobalConfig.lua", "Lua", 0, 3, 0, 0, 0, 1, 4
"c:\Users\colin\OneDrive\Documents\Projects\JJKBattlegrounds\src\Shared\Enums\Input.lua", "Lua", 0, 19, 0, 0, 0, 4, 23
"c:\Users\colin\OneDrive\Documents\Projects\JJKBattlegrounds\src\Shared\Global\DebugUtil.lua", "Lua", 0, 21, 0, 0, 3, 5, 29
"c:\Users\colin\OneDrive\Documents\Projects\JJKBattlegrounds\src\Shared\Global\InjectLifecycleSignals.lua", "Lua", 0, 17, 0, 0, 3, 8, 28
"c:\Users\colin\OneDrive\Documents\Projects\JJKBattlegrounds\src\Shared\Global\Schedules.lua", "Lua", 0, 54, 0, 0, 0, 14, 68
"c:\Users\colin\OneDrive\Documents\Projects\JJKBattlegrounds\src\Shared\Global\Util.lua", "Lua", 0, 274, 0, 0, 13, 69, 356
"c:\Users\colin\OneDrive\Documents\Projects\JJKBattlegrounds\src\Shared\Global\World.lua", "Lua", 0, 9, 0, 0, 0, 4, 13
"c:\Users\colin\OneDrive\Documents\Projects\JJKBattlegrounds\src\Shared\Global\init.lua", "Lua", 0, 24, 0, 0, 1, 6, 31
"c:\Users\colin\OneDrive\Documents\Projects\JJKBattlegrounds\src\Shared\Globals.lua", "Lua", 0, -27, 0, 0, -1, -9, -37
"c:\Users\colin\OneDrive\Documents\Projects\JJKBattlegrounds\src\Shared\Modules\ActionMetaData.lua", "Lua", 0, 19, 0, 0, 0, 8, 27
"c:\Users\colin\OneDrive\Documents\Projects\JJKBattlegrounds\src\Shared\Modules\ActionUtil.lua", "Lua", 0, 2, 0, 0, -3, 2, 1
"c:\Users\colin\OneDrive\Documents\Projects\JJKBattlegrounds\src\Shared\Modules\Animate.lua", "Lua", 0, -107, 0, 0, 0, -23, -130
"c:\Users\colin\OneDrive\Documents\Projects\JJKBattlegrounds\src\Shared\Modules\AnimationReplacer.lua", "Lua", 0, 39, 0, 0, 5, 11, 55
"c:\Users\colin\OneDrive\Documents\Projects\JJKBattlegrounds\src\Shared\Modules\AnimationToMarkerData.lua", "Lua", 0, 35, 0, 0, 0, 12, 47
"c:\Users\colin\OneDrive\Documents\Projects\JJKBattlegrounds\src\Shared\Modules\Characters\Default\Ascension\Activate.lua", "Lua", 0, -1, 0, 0, 0, -1, -2
"c:\Users\colin\OneDrive\Documents\Projects\JJKBattlegrounds\src\Shared\Modules\Characters\Default\Ascension\Ascension1.lua", "Lua", 0, -5, 0, 0, 0, -1, -6
"c:\Users\colin\OneDrive\Documents\Projects\JJKBattlegrounds\src\Shared\Modules\Characters\Default\Ascension\Ascension2.lua", "Lua", 0, -1, 0, 0, 0, -1, -2
"c:\Users\colin\OneDrive\Documents\Projects\JJKBattlegrounds\src\Shared\Modules\Characters\Default\Ascension\Ascension3.lua", "Lua", 0, -1, 0, 0, 0, -1, -2
"c:\Users\colin\OneDrive\Documents\Projects\JJKBattlegrounds\src\Shared\Modules\Characters\Default\Ascension\Ascension4.lua", "Lua", 0, -1, 0, 0, 0, -1, -2
"c:\Users\colin\OneDrive\Documents\Projects\JJKBattlegrounds\src\Shared\Modules\Characters\Default\Ascension\M1.lua", "Lua", 0, -1, 0, 0, 0, -1, -2
"c:\Users\colin\OneDrive\Documents\Projects\JJKBattlegrounds\src\Shared\Modules\Characters\Default\Ascension\Passives.lua", "Lua", 0, -1, 0, 0, 0, -1, -2
"c:\Users\colin\OneDrive\Documents\Projects\JJKBattlegrounds\src\Shared\Modules\Characters\Default\Normal\Ability1.lua", "Lua", 0, -74, 0, 0, -19, -27, -120
"c:\Users\colin\OneDrive\Documents\Projects\JJKBattlegrounds\src\Shared\Modules\Characters\Default\Normal\Ability2.lua", "Lua", 0, -1, 0, 0, 0, -1, -2
"c:\Users\colin\OneDrive\Documents\Projects\JJKBattlegrounds\src\Shared\Modules\Characters\Default\Normal\Ability3.lua", "Lua", 0, -1, 0, 0, 0, -1, -2
"c:\Users\colin\OneDrive\Documents\Projects\JJKBattlegrounds\src\Shared\Modules\Characters\Default\Normal\Ability4.lua", "Lua", 0, -1, 0, 0, 0, -1, -2
"c:\Users\colin\OneDrive\Documents\Projects\JJKBattlegrounds\src\Shared\Modules\Characters\Default\Normal\M1.lua", "Lua", 0, -53, 0, 0, 0, -18, -71
"c:\Users\colin\OneDrive\Documents\Projects\JJKBattlegrounds\src\Shared\Modules\Characters\Default\Normal\Passives.lua", "Lua", 0, -1, 0, 0, 0, -1, -2
"c:\Users\colin\OneDrive\Documents\Projects\JJKBattlegrounds\src\Shared\Modules\Characters\Default\init.lua", "Lua", 0, -4, 0, 0, 0, -1, -5
"c:\Users\colin\OneDrive\Documents\Projects\JJKBattlegrounds\src\Shared\Modules\Characters\Kashimo\Abilities\Ability1.lua", "Lua", 0, -1, 0, 0, 0, -1, -2
"c:\Users\colin\OneDrive\Documents\Projects\JJKBattlegrounds\src\Shared\Modules\Characters\Kashimo\Abilities\Ability2.lua", "Lua", 0, -1, 0, 0, 0, -1, -2
"c:\Users\colin\OneDrive\Documents\Projects\JJKBattlegrounds\src\Shared\Modules\Characters\Kashimo\Abilities\Ability3.lua", "Lua", 0, -1, 0, 0, 0, -1, -2
"c:\Users\colin\OneDrive\Documents\Projects\JJKBattlegrounds\src\Shared\Modules\Characters\Kashimo\Abilities\Ability4.lua", "Lua", 0, -1, 0, 0, 0, -1, -2
"c:\Users\colin\OneDrive\Documents\Projects\JJKBattlegrounds\src\Shared\Modules\Characters\Kashimo\Abilities\M1.lua", "Lua", 0, -1, 0, 0, 0, -1, -2
"c:\Users\colin\OneDrive\Documents\Projects\JJKBattlegrounds\src\Shared\Modules\Characters\Kashimo\Abilities\Passives.lua", "Lua", 0, 0, 0, 0, 0, -1, -1
"c:\Users\colin\OneDrive\Documents\Projects\JJKBattlegrounds\src\Shared\Modules\Characters\Kashimo\Ascension\Activate.lua", "Lua", 0, -1, 0, 0, 0, -1, -2
"c:\Users\colin\OneDrive\Documents\Projects\JJKBattlegrounds\src\Shared\Modules\Characters\Kashimo\Ascension\Ascension1.lua", "Lua", 0, -4, 0, 0, 0, -1, -5
"c:\Users\colin\OneDrive\Documents\Projects\JJKBattlegrounds\src\Shared\Modules\Characters\Kashimo\Ascension\Ascension2.lua", "Lua", 0, -1, 0, 0, 0, -1, -2
"c:\Users\colin\OneDrive\Documents\Projects\JJKBattlegrounds\src\Shared\Modules\Characters\Kashimo\Ascension\Ascension3.lua", "Lua", 0, -1, 0, 0, 0, -1, -2
"c:\Users\colin\OneDrive\Documents\Projects\JJKBattlegrounds\src\Shared\Modules\Characters\Kashimo\Ascension\Ascension4.lua", "Lua", 0, -1, 0, 0, 0, -1, -2
"c:\Users\colin\OneDrive\Documents\Projects\JJKBattlegrounds\src\Shared\Modules\Characters\Kashimo\Ascension\M1.lua", "Lua", 0, -1, 0, 0, 0, -1, -2
"c:\Users\colin\OneDrive\Documents\Projects\JJKBattlegrounds\src\Shared\Modules\Characters\Kashimo\Ascension\Passives.lua", "Lua", 0, 0, 0, 0, 0, -1, -1
"c:\Users\colin\OneDrive\Documents\Projects\JJKBattlegrounds\src\Shared\Modules\Characters\Kashimo\init.lua", "Lua", 0, -4, 0, 0, 0, -1, -5
"c:\Users\colin\OneDrive\Documents\Projects\JJKBattlegrounds\src\Shared\Modules\CooldownControl.lua", "Lua", 0, 25, 0, 0, 1, 10, 36
"c:\Users\colin\OneDrive\Documents\Projects\JJKBattlegrounds\src\Shared\Modules\HitAnimation.lua", "Lua", 0, 11, 0, 0, 0, 8, 19
"c:\Users\colin\OneDrive\Documents\Projects\JJKBattlegrounds\src\Shared\Modules\HitDetection.lua", "Lua", 0, 50, 0, 0, 2, 15, 67
"c:\Users\colin\OneDrive\Documents\Projects\JJKBattlegrounds\src\Shared\Modules\InjectLifecycleSignals.lua", "Lua", 0, -22, 0, 0, -3, -8, -33
"c:\Users\colin\OneDrive\Documents\Projects\JJKBattlegrounds\src\Shared\Modules\Util.lua", "Lua", 0, -104, 0, 0, -13, -32, -149
"c:\Users\colin\OneDrive\Documents\Projects\JJKBattlegrounds\src\Shared\Modules\VFXUtil\BubbleVFX\init.lua", "Lua", 0, 42, 0, 0, 2, 9, 53
"c:\Users\colin\OneDrive\Documents\Projects\JJKBattlegrounds\src\Shared\Modules\VFXUtil\GetFloor.lua", "Lua", 0, 5, 0, 0, 0, 2, 7
"c:\Users\colin\OneDrive\Documents\Projects\JJKBattlegrounds\src\Shared\Modules\VFXUtil\RockVFX.lua", "Lua", 0, 236, 0, 0, 0, 56, 292
"c:\Users\colin\OneDrive\Documents\Projects\JJKBattlegrounds\src\Shared\NPC\Classes\NPCEntity.lua", "Lua", 0, 10, 0, 0, 1, 6, 17
"c:\Users\colin\OneDrive\Documents\Projects\JJKBattlegrounds\src\Shared\NPC\Jobs\Lifecycle.lua", "Lua", 0, 10, 0, 0, 0, 4, 14
"c:\Users\colin\OneDrive\Documents\Projects\JJKBattlegrounds\src\Shared\Player\Components\ActionSet.lua", "Lua", 0, 45, 0, 0, 0, 15, 60
"c:\Users\colin\OneDrive\Documents\Projects\JJKBattlegrounds\src\Shared\Player\Components\Character.lua", "Lua", 0, 17, 0, 0, 0, 9, 26
"c:\Users\colin\OneDrive\Documents\Projects\JJKBattlegrounds\src\Shared\Player\Components\Cooldowns.lua", "Lua", 0, 43, 0, 0, 0, 9, 52
"c:\Users\colin\OneDrive\Documents\Projects\JJKBattlegrounds\src\Shared\Player\Components\Player.lua", "Lua", 0, 17, 0, 0, 0, 9, 26
"c:\Users\colin\OneDrive\Documents\Projects\JJKBattlegrounds\src\Shared\Player\Components\PlayingAction.lua", "Lua", 0, 31, 0, 0, 0, 11, 42
"c:\Users\colin\OneDrive\Documents\Projects\JJKBattlegrounds\src\Shared\Player\Jobs\BootPlayers.lua", "Lua", 0, 34, 0, 0, 0, 11, 45
"c:\Users\colin\OneDrive\Documents\Projects\JJKBattlegrounds\src\Shared\Player\Modules\ActionToActionEnum.lua", "Lua", 0, 12, 0, 0, 0, 6, 18
"c:\Users\colin\OneDrive\Documents\Projects\JJKBattlegrounds\src\Shared\Player\Modules\CharacterEntityTracker.lua", "Lua", 0, 9, 0, 0, 0, 5, 14
"c:\Users\colin\OneDrive\Documents\Projects\JJKBattlegrounds\src\Shared\Player\Modules\PlayerEntityTracker.lua", "Lua", 0, 9, 0, 0, 0, 5, 14
"c:\Users\colin\OneDrive\Documents\Projects\JJKBattlegrounds\src\Start\Client.client.lua", "Lua", 0, 4, 0, 0, 0, 0, 4
"c:\Users\colin\OneDrive\Documents\Projects\JJKBattlegrounds\src\Start\Server.server.lua", "Lua", 0, 6, 0, 0, 0, 1, 7
"c:\Users\colin\OneDrive\Documents\Projects\JJKBattlegrounds\wally.lock", "TOML", 4, 0, 0, 0, 0, 1, 5
"c:\Users\colin\OneDrive\Documents\Projects\JJKBattlegrounds\wally.toml", "TOML", 1, 0, 0, 0, 0, -1, 0
"Total", "-", 31, 20657, 202, 12, 1633, 5245, 27780